"","idx","positive","negative","sentiment","covid","DateTime","Text"
"1",1,1,0,1,FALSE,"2020-04-11 23:51:58+00:00","Will be interviewed by @JudgeJeanine tonight at 9:00 P.M. Eastern on @FoxNews!"
"2",2,2,6,-4,TRUE,"2020-04-11 23:34:58+00:00","So now the Fake News @nytimes is tracing the CoronaVirus origins back to Europe, NOT China. This is a first! I wonder what the Failing New York Times got for this one? Are there any NAMED sources? They were recently thrown out of China like dogs, and obviously want back in. Sad!"
"3",3,5,6,-1,FALSE,"2020-04-11 23:28:18+00:00","Governor @GavinNewsom of California has been very nice & highly supportive about the great job we have done, working together, for California. That is the good news, but this is the bad. He is unfairly under attack by the Radical Left Dems, MSDNC etc. He is strong! Will he fold?"
"4",4,1,0,1,FALSE,"2020-04-11 22:38:29+00:00","I will be watching. HAVE A GREAT EASTER!"
"5",5,4,6,-2,FALSE,"2020-04-11 22:35:35+00:00","The Wall Street Journal Editorial Board doesn’t have a clue on how to fight and win. Their views on Tariffs & Trade are losers for the U.S., but winners for other countries, including China. If we followed their standards, we’d have no Country left. They should love Sleepy Joe!"
"6",6,3,1,2,FALSE,"2020-04-11 21:53:36+00:00","Watching @FoxNews on weekend afternoons is a total waste of time. We now have some great alternatives, like @OANN."
"7",7,4,5,-1,TRUE,"2020-04-11 21:48:58+00:00","“The President and the Federal Government are doing an excellent job. When they say the death toll isn’t going to be as high as reported, they (the opposition) act like they’re sad because it’s lower. I think they are (Press Conferences) wonderful.” West Virginia Resident, C Span"
"8",8,1,0,1,FALSE,"2020-04-11 21:36:48+00:00","Great editorial by @SenRonJohnson!"
"9",9,1,0,1,TRUE,"2020-04-11 21:08:43+00:00","Wishing all a safe and blessed Easter Sunday. I will be tuning into Pastor @robertjeffress at http://firstdallas.org/liveworship Church in Dallas, Texas tomorrow morning at 10:20 AM Eastern."
"10",10,0,0,0,FALSE,"2020-04-11 18:53:59+00:00","WE WILL BUILD IT AGAIN!"
"11",11,0,2,-2,FALSE,"2020-04-11 18:47:39+00:00","....Does anyone ever notice how few quotes from an actual person are given nowadays by the Lamestream Media. Very seldom. The unnamed or anonymous sources are almost always FAKE NEWS."
"12",12,0,3,-3,FALSE,"2020-04-11 18:43:03+00:00","When the Failing @nytimes or Amazon @washingtonpost writes a story saying “unnamed sources said”, or any such phrase where a person’s name is not used, don’t believe them. Most of these unnamed sources don’t exist. They are made up to defame & disparage. They have no “source”..."
"13",13,5,2,3,FALSE,"2020-04-11 18:33:04+00:00","....economy was shuttered. This is unprecedented, it is unsettling and challenging but, we will rise to meet the occasion.” MACK MCLARTY, Clinton White House Chief of Staff. @LelandVittert @FoxNews Thank you Mack. We will be bigger, better and stronger than ever before!"
"14",14,2,0,2,TRUE,"2020-04-11 18:33:03+00:00","“I think the situation is unprecedented, and there is no question about that. It’s whiplash! The economy was moving forward at a rapid pace in terms of growth, jobs and even wage increases, and all of a sudden the pandemic hit and the...."
"15",15,3,0,3,FALSE,"2020-04-11 16:01:37+00:00","“Trump did a deal with Japan. A lot of our product goes to Japan, and we are booming in North Dakota.” Jim on C Span, Washington Journal. Our Trade Deals will be having a big impact on our Country as they kick in!"
"16",16,0,0,0,FALSE,"2020-04-10 16:44:53+00:00",""
"17",17,2,5,-3,FALSE,"2020-04-10 15:42:10+00:00","Nobody wants to say that if Elizabeth Warren gets out of the race before Super Tuesday, Crazy Bernie Sanders wins virtually every state in a blowout...NOT EVEN CLOSE! I haven’t heard one member of the Fake News Establishment even mention this irrefutable fact. FAKE NEWS!"
"18",18,0,3,-3,FALSE,"2020-04-10 15:15:25+00:00","The Invisible Enemy will soon be in full retreat!"
"19",19,0,6,-6,FALSE,"2020-04-10 14:36:41+00:00","Because the T.V. Ratings for the White House News Conference’s are the highest, the Opposition Party (Lamestream Media), the Radical Left, Do Nothing Democrats &, of course, the few remaining RINO’S, are doing everything in their power to disparage & end them. The People’s Voice!"
"20",20,1,0,1,FALSE,"2020-04-10 14:35:20+00:00","The White House Press Conference will take place today at 1:00 P.M., recognizing that it is Good Friday!"
"21",21,2,0,2,FALSE,"2020-04-10 14:32:33+00:00","HAPPY GOOD FRIDAY TO ALL!"
"22",22,4,0,4,FALSE,"2020-04-10 14:14:28+00:00","Wow, Approval Rating in the Republican Party - 96%. Thank you!"
"23",23,1,0,1,FALSE,"2020-04-10 12:36:15+00:00","Not good Gregg, but it is what it is. Have to save the airlines!"
"24",24,2,0,2,FALSE,"2020-04-10 11:48:26+00:00","Congress must go back to DEDUCTIBILITY by businesses if Restaurants, Clubs & Entertaiment is expected to flourish (like never before)!"
"25",25,1,1,0,FALSE,"2020-04-10 11:32:26+00:00","Democrats are blocking a 251 Billion Dollar funding boost for Small Businesses which will help them keep their employees. It should be for only that reason, with no additions. We should have a big Infrastructure Phase Four with Payroll Tax Cuts & more. Big Economic Bounceback!"
"26",26,1,2,-1,FALSE,"2020-04-10 11:30:20+00:00","This week, in only 4 days, we had the biggest Stock Market increase since 1974. We have a great chance for the really big bounce when the Invisible Enemy is gone!"
"27",27,1,0,1,FALSE,"2020-04-10 04:57:58+00:00","Tim Scott is Great!"
"28",28,1,3,-2,FALSE,"2020-04-10 04:56:21+00:00","Thank you Frank. It’s ABC Fake News. They knew they were wrong when they went with this Hoax of a story!"
"29",29,1,0,1,FALSE,"2020-04-10 04:45:48+00:00","Thank you Erin!"
"30",30,1,0,1,FALSE,"2020-04-10 00:42:29+00:00","....We will always be there for our Great Farmers, Cattlemen, Ranchers, and Producers!"
"31",31,4,1,3,TRUE,"2020-04-10 00:42:28+00:00","I have directed @SecretarySonny to expedite help to our farmers, especially to the smaller farmers who are hurting right now. I expect Secretary Purdue to use all of the funds and authorities at his disposal to make sure that our food supply is stable, strong, and safe...."
"32",32,0,3,-3,FALSE,"2020-04-09 19:35:00+00:00","The Wall Street Journal always “forgets” to mention that the ratings for the White House Press Briefings are “through the roof” (Monday Night Football, Bachelor Finale, according to @nytimes) & is only way for me to escape the Fake News & get my views across. WSJ is Fake News!"
"33",33,2,0,2,FALSE,"2020-04-09 18:39:20+00:00","Great News: Prime Minister Boris Johnson has just been moved out of Intensive Care. Get well Boris!!!"
"34",34,2,2,0,FALSE,"2020-04-09 15:51:56+00:00","On National Former Prisoner of War Recognition Day, we honor the more than 500,000 American warriors captured while protecting our way of life. We pay tribute to these Patriots for their unwavering and unrelenting spirit!"
"35",35,1,1,0,TRUE,"2020-04-09 15:08:05+00:00",".@OANN A key CoronaVirus Model is now predicting far fewer deaths than the number shown in earlier models. That’s because the American people are doing a great job. Social Distancing etc. Keep going!"
"36",36,2,2,0,FALSE,"2020-04-08 23:34:27+00:00","Absentee Ballots are a great way to vote for the many senior citizens, military, and others who can’t get to the polls on Election Day. These ballots are very different from 100% Mail-In Voting, which is “RIPE for FRAUD,” and shouldn’t be allowed!"
"37",37,3,0,3,FALSE,"2020-04-08 23:15:03+00:00","This morning, 450,000 protective suits landed in Dallas, Texas. This was made possible because of the partnership of two great American companies—DuPont and FedEx—and our friends in Vietnam. Thank you! @DuPont_News @FedEx"
"38",38,0,0,0,FALSE,"2020-04-08 22:48:50+00:00",""
"39",39,1,0,1,FALSE,"2020-04-08 20:50:34+00:00","Wishing a HAPPY PASSOVER to those celebrating in the United States, Israel, and around the world!"
"40",40,1,0,1,FALSE,"2020-04-08 20:37:12+00:00","White House news conference at 5:30 P.M. Eastern. Thank you!"
"41",41,5,0,5,FALSE,"2020-04-08 18:11:51+00:00","Extraordinary times require even closer cooperation between friends. Thank you India and the Indian people for the decision on HCQ. Will not be forgotten! Thank you Prime Minister @NarendraModi for your strong leadership in helping not just India, but humanity, in this fight!"
"42",42,1,2,-1,FALSE,"2020-04-08 16:12:24+00:00","Can’t see AOC plus 3 supporting Sleepy Joe!"
"43",43,1,2,-1,FALSE,"2020-04-08 16:09:38+00:00","Wow, Bernie is unwilling to give up his delegates, and wants more of them! What’s that all about?"
"44",44,5,7,-2,FALSE,"2020-04-08 15:49:28+00:00","Bernie Sanders is OUT! Thank you to Elizabeth Warren. If not for her, Bernie would have won almost every state on Super Tuesday! This ended just like the Democrats & the DNC wanted, same as the Crooked Hillary fiasco. The Bernie people should come to the Republican Party, TRADE!"
"45",45,0,0,0,TRUE,"2020-04-08 15:26:20+00:00","FLATTENING OF THE CURVE!"
"46",46,6,4,2,FALSE,"2020-04-08 14:52:56+00:00","Once we OPEN UP OUR GREAT COUNTRY, and it will be sooner rather than later, the horror of the Invisible Enemy, except for those that sadly lost a family member or friend, must be quickly forgotten. Our Economy will BOOM, perhaps like never before!!!"
"47",47,2,6,-4,FALSE,"2020-04-08 14:42:25+00:00","...the Fake News Media into not covering them, but that effort failed because the ratings are through the roof according to, of all sources, the Failing New York Times, “Monday Night Football, Bachelor Finale” type numbers (& sadly, they get it FREE). Trump Derangement Syndrome!"
"48",48,1,8,-7,FALSE,"2020-04-08 14:42:24+00:00","The Radical Left Democrats have gone absolutely crazy that I am doing daily Presidential News Conferences. They actually want me to STOP! They used to complain that I am not doing enough of them, now they complain that I “shouldn’t be allowed to do them.” They tried to shame....."
"49",49,0,0,0,TRUE,"2020-04-08 12:46:01+00:00","Will be immediately sending 100 Ventilators to Colorado at the request of Senator Gardner!"
"50",50,5,3,2,FALSE,"2020-04-08 12:20:48+00:00","Republicans should fight very hard when it comes to state wide mail-in voting. Democrats are clamoring for it. Tremendous potential for voter fraud, and for whatever reason, doesn’t work out well for Republicans. @foxandfriends"
"51",51,2,0,2,TRUE,"2020-04-08 12:07:27+00:00","“The number of New Yorkers admitted to hospitals has dropped.” @ainsleyearhardt @foxandfriends Good news!"
"52",52,0,0,0,FALSE,"2020-04-07 22:43:41+00:00",""
"53",53,0,0,0,FALSE,"2020-04-07 22:43:26+00:00",""
"54",54,0,0,0,FALSE,"2020-04-07 21:29:52+00:00",""
"55",55,1,0,1,FALSE,"2020-04-07 21:03:47+00:00","White House news conference at 5:30 P.M. Eastern. Thank you!"
"56",56,0,0,0,FALSE,"2020-04-07 20:39:01+00:00",""
"57",57,2,1,1,FALSE,"2020-04-07 20:03:03+00:00","Just had a conf call w/ major lenders discussing our Great Small Businesses & the #PPPloan. I ask every company, big & small, making announcements about innovative contributions, hiring new workers, or looking to overcome setbacks to share your stories with #AmericaWorksTogether!"
"58",58,1,0,1,FALSE,"2020-04-07 15:26:45+00:00","Wisconsin, get out and vote NOW for Justice Daniel Kelly. Protect your 2nd Amendment!"
"59",59,0,4,-4,TRUE,"2020-04-07 15:22:46+00:00","Why didn’t the I.G., who spent 8 years with the Obama Administration (Did she Report on the failed H1N1 Swine Flu debacle where 17,000 people died?), want to talk to the Admirals, Generals, V.P. & others in charge, before doing her report. Another Fake Dossier!"
"60",60,3,4,-1,FALSE,"2020-04-07 15:04:16+00:00","The W.H.O. really blew it. For some reason, funded largely by the United States, yet very China centric. We will be giving that a good look. Fortunately I rejected their advice on keeping our borders open to China early on. Why did they give us such a faulty recommendation?"
"61",61,4,1,3,FALSE,"2020-04-07 04:35:42+00:00","Vote today, Tuesday, for highly respected Republican, Justice Daniel Kelly. Tough on Crime, loves your Military, Vets, Farmers, & will save your 2nd Amendment. A BIG VOTE!"
"62",62,2,0,2,FALSE,"2020-04-07 03:39:01+00:00","Great job being done by Dr. Nicole Saphier on @FoxNews!"
"63",63,0,0,0,FALSE,"2020-04-07 03:32:12+00:00",""
"64",64,0,0,0,FALSE,"2020-04-07 00:10:56+00:00",""
"65",65,0,0,0,FALSE,"2020-04-07 00:10:15+00:00",""
"66",66,2,0,2,TRUE,"2020-04-07 00:09:52+00:00","The Wisconsin Supreme Court ruled that tomorrow’s election will proceed as scheduled. VOTE for Justice Daniel Kelly tomorrow, and be safe!"
"67",67,1,0,1,FALSE,"2020-04-06 21:25:42+00:00","White House news conference at 5:45 P.M. Eastern. Thank you!"
"68",68,3,0,3,FALSE,"2020-04-06 21:03:59+00:00","Congratulations to State Representative Karen Whitsett of Michigan. So glad you are getting better!"
"69",69,0,0,0,FALSE,"2020-04-06 18:32:32+00:00",""
"70",70,1,4,-3,FALSE,"2020-04-06 15:34:27+00:00","Joe Biden wanted the date for the Democrat National Convention moved to a later time period. Now he wants a “Virtual” Convention, one where he doesn’t have to show up. Gee, I wonder why? Also, what ever happened to that phone call he told the Fake News he wanted to make to me?"
"71",71,2,5,-3,TRUE,"2020-04-06 13:08:58+00:00","Advertising in the Failing New York Times is WAY down. Washington Post is not much better. I can’t say whether this is because they are Fake News sources of information, to a level that few can understand, or the Virus is just plain beating them up. Fake News is bad for America!"
"72",72,0,0,0,FALSE,"2020-04-06 11:55:14+00:00","LIGHT AT THE END OF THE TUNNEL!"
"73",73,1,0,1,FALSE,"2020-04-06 11:54:33+00:00","USA STRONG!"
"74",74,1,5,-4,FALSE,"2020-04-06 11:53:00+00:00","Thank you Gayle. I only wish the public could fully understand how corrupt & dishonest so much of our Lamestream Media is. My Press Conferences are vital. They are reaching millions of people that are not being told the truth, & haven’t been for years (Witch-Hunts, Fake News)!"
"75",75,1,4,-3,TRUE,"2020-04-06 11:49:57+00:00","For humanitarian reasons, the passengers from the two CoronaVirus stricken cruise ships have been given medical treatment and, when appropriate, allowed to disembark, under strict supervision. Very carefully done. People we’re dying & no other countries would allow them to dock!"
"76",76,2,3,-1,FALSE,"2020-04-06 11:40:45+00:00",".@gayletrotter “To this day the establishment media have not admitted that they were wrong and the President was right.” @FoxNews"
"77",77,0,0,0,FALSE,"2020-04-06 00:51:56+00:00",""
"78",78,0,0,0,FALSE,"2020-04-06 00:51:50+00:00",""
"79",79,1,0,1,FALSE,"2020-04-05 22:19:59+00:00","White House news conference at 6:45 P.M. Eastern. Thank you!"
"80",80,4,2,2,FALSE,"2020-04-05 19:35:34+00:00","We are learning much about the Invisible Enemy. It is tough and smart, but we are tougher and smarter!"
"81",81,1,0,1,FALSE,"2020-04-05 16:30:32+00:00","Thank you Gayle!"
"82",82,0,0,0,FALSE,"2020-04-05 16:26:33+00:00","I agree!"
"83",83,0,1,-1,FALSE,"2020-04-05 16:25:57+00:00","A very biased “journalist”."
"84",84,2,0,2,FALSE,"2020-04-05 16:23:40+00:00","A great & wonderful woman!"
"85",85,0,1,-1,FALSE,"2020-04-05 16:20:41+00:00","Corrected Fake News!"
"86",86,1,0,1,FALSE,"2020-04-05 02:02:59+00:00","He wants to raise taxes all over our Country!"
"87",87,0,1,-1,FALSE,"2020-04-05 01:59:39+00:00","Disgraceful!"
"88",88,3,0,3,FALSE,"2020-04-04 23:25:14+00:00","Palm Sunday is the beginning of a Holy week for many people of Faith and a great day to lift our voices in Prayer. I will be tuning into Pastor @greglaurie at @harvestorg Church in Riverside, California tomorrow at 11:00 A.M. Eastern."
"89",89,0,0,0,FALSE,"2020-04-04 19:40:07+00:00","....We will get through this together, and bats will be swinging before you know it. In the meantime, take care of mom and dad, and know that this will not be forever! @littleleagueceo"
"90",90,0,1,-1,FALSE,"2020-04-04 19:40:06+00:00","To all of our youth who are missing the start of their @LittleLeague seasons, hang in there! We will get you back out on the fields, and know that you will be playing baseball soon...."
"91",91,3,0,3,FALSE,"2020-04-04 19:19:53+00:00","The Paycheck Protection Program is up and running! The program is open to nonprofits as well, so banks be sure to sign up our Great Religious and Veteran Organizations that need help!"
"92",92,1,2,-1,TRUE,"2020-04-04 19:10:23+00:00","America owes our very hard working food supply workers so much as they produce and deliver high quality food for us during this horrible COVID-19. Join me in thanking our Farmers, Ranchers, Processors, Distributors and Stores! @JohnBoozman"
"93",93,0,0,0,FALSE,"2020-04-04 18:30:39+00:00",""
"94",94,1,0,1,FALSE,"2020-04-04 17:09:23+00:00","I will be holding a News Conference at 3:30 P.M. at the White House. Thank you!"
"95",95,1,4,-3,FALSE,"2020-04-04 17:07:39+00:00",".@CNN is Fake News. They will take a good story and make it as bad as is humanly possible. They are a JOKE!"
"96",96,1,0,1,FALSE,"2020-04-04 17:05:16+00:00","Good idea Dana!"
"97",97,1,0,1,FALSE,"2020-04-04 15:27:02+00:00","Great!"
"98",98,0,0,0,FALSE,"2020-04-04 15:17:20+00:00","I agree with this. Watch!"
"99",99,1,0,1,FALSE,"2020-04-04 15:09:33+00:00","I will immediately ask Congress for more money to support small businesses under the #PPPloan if the allocated money runs out. So far, way ahead of schedule. @BankofAmerica & community banks are rocking! @SBAgov @USTreasury"
"100",100,0,0,0,FALSE,"2020-04-04 13:48:32+00:00","I fully agree!"
"101",101,1,0,1,FALSE,"2020-04-04 13:41:32+00:00","Thank you Cory!"
"102",102,4,0,4,FALSE,"2020-04-03 18:49:51+00:00","Great job being done by @BankofAmerica and many community banks throughout the country. Small businesses appreciate your work!"
"103",103,3,0,3,FALSE,"2020-04-03 17:51:15+00:00","The Paycheck Protection Program is now available! #CARESAct Small Business Guidance & Loan Resources: http://SBA.gov"
"104",104,1,0,1,FALSE,"2020-04-03 17:33:21+00:00","Thank you @DeptofDefense, @USACEHQ, @USNationalGuard, @FEMA, and @CDCgov! http://CoronaVirus.gov"
"105",105,3,0,3,FALSE,"2020-04-03 17:29:14+00:00","Thank you @USNationalGuard, keep up the great work!"
"106",106,5,0,5,FALSE,"2020-04-03 17:14:22+00:00","GREAT news this week regarding the Keystone XL Pipeline – moving forward with fantastic paying CONSTRUCTION jobs for hardworking Americans. Promises Made, Promises Kept! #MAGA"
"107",107,7,1,6,FALSE,"2020-04-03 17:12:57+00:00","Highly respected Justice Daniel Kelly is running for the Supreme Court in the Great State of Wisconsin. Justice Kelly has been doing a terrific job upholding the Rule of Law and defending your #2A. Tough on Crime, Loves our Military and our Vets. He has my Complete Endorsement!"
"108",108,0,1,-1,TRUE,"2020-04-03 00:52:35+00:00","We hit 3M hard today after seeing what they were doing with their Masks. “P Act” all the way. Big surprise to many in government as to what they were doing - will have a big price to pay!"
"109",109,0,0,0,FALSE,"2020-04-03 00:15:24+00:00",""
"110",110,0,0,0,FALSE,"2020-04-03 00:13:17+00:00",""
"111",111,0,1,-1,TRUE,"2020-04-02 16:48:26+00:00","30 DAYS TO SLOW THE SPREAD"
"112",112,2,0,2,FALSE,"2020-04-02 14:54:55+00:00",".....Could be as high as 15 Million Barrels. Good (GREAT) news for everyone!"
"113",113,1,2,-1,FALSE,"2020-04-02 14:32:08+00:00","Just spoke to my friend MBS (Crown Prince) of Saudi Arabia, who spoke with President Putin of Russia, & I expect & hope that they will be cutting back approximately 10 Million Barrels, and maybe substantially more which, if it happens, will be GREAT for the oil & gas industry!"
"114",114,1,0,1,FALSE,"2020-04-02 14:12:56+00:00","“The States have to get the money to the people who need it.” @MariaBartiromo And FAST!"
"115",115,3,1,2,TRUE,"2020-04-02 13:17:22+00:00","....have been stocked up and ready long before this crisis hit. Other states are thrilled with the job we have done. Sending many Ventilators today, with thousands being built. 51 large cargo planes coming in with medical supplies. Prefer sending directly to hospitals."
"116",116,2,1,1,TRUE,"2020-04-02 13:17:21+00:00","Massive amounts of medical supplies, even hospitals and medical centers, are being delivered directly to states and hospitals by the Federal Government. Some have insatiable appetites & are never satisfied (politics?). Remember, we are a backup for them. The complainers should..."
"117",117,2,4,-2,TRUE,"2020-04-02 12:57:41+00:00","...It wouldn’t matter if you got ten times what was needed, it would never be good enough. Unlike other states, New York unfortunately got off to a late start. You should have pushed harder. Stop complaining & find out where all of these supplies are going. Cuomo working hard!"
"118",118,2,1,1,TRUE,"2020-04-02 12:57:41+00:00","Somebody please explain to Cryin’ Chuck Schumer that we do have a military man in charge of distributing goods, a very talented Admiral, in fact. New York has gotten far more than any other State, including hospitals & a hospital ship, but no matter what, always complaining....."
"119",119,0,4,-4,FALSE,"2020-04-01 17:05:30+00:00","Upon information and belief, Iran or its proxies are planning a sneak attack on U.S. troops and/or assets in Iraq. If this happens, Iran will pay a very heavy price, indeed!"
"120",120,3,0,3,FALSE,"2020-04-01 16:36:30+00:00","Congress must pass the old, and very strongly proven, deductibility by businesses on restaurants and entertainment. This will bring restaurants, and everything related, back - and stronger than ever. Move quickly, they will all be saved!"
"121",121,0,0,0,FALSE,"2020-04-01 00:32:46+00:00",""
"122",122,0,0,0,FALSE,"2020-04-01 00:32:16+00:00",""
"123",123,0,1,-1,TRUE,"2020-03-31 23:49:05+00:00","30 DAYS TO SLOW THE SPREAD #COVIDー19 http://CoronaVirus.gov"
"124",124,3,0,3,FALSE,"2020-03-31 20:56:23+00:00","Great work @AtlasAirWW, thank you!"
"125",125,0,0,0,FALSE,"2020-03-31 20:27:41+00:00","Will be starting The White House news conference at 5:15 P.M. Eastern."
"126",126,3,1,2,FALSE,"2020-03-31 19:52:52+00:00","My proposal to the politically correct Automobile Companies would lower the average price of a car to consumers by more than 3500, while at the same time making the cars substantially safer. Engines would run smoother. Positive impact on the environment! Foolish executives!"
"127",127,2,4,-2,FALSE,"2020-03-31 19:51:32+00:00","My Administration is helping U.S. auto workers by replacing the failed Obama Emissions Rule. Impossible to satisfy its Green New Deal Standard; Lots of unnecessary and expensive penalties to car buyers!"
"128",128,5,1,4,TRUE,"2020-03-31 19:50:29+00:00","Great news! American families will now be able to buy safer, more affordable, and environmentally friendly cars with our new SAFE VEHICLES RULE. Get rid of those old, unsafe clunkers. Build better and safer American cars and create American jobs. Buy American!"
"129",129,1,1,0,FALSE,"2020-03-31 14:55:00+00:00","Thank you Mike!"
"130",130,2,0,2,FALSE,"2020-03-31 14:48:43+00:00","With interest rates for the United States being at ZERO, this is the time to do our decades long awaited Infrastructure Bill. It should be VERY BIG & BOLD, Two Trillion Dollars, and be focused solely on jobs and rebuilding the once great infrastructure of our Country! Phase 4"
"131",131,1,7,-6,FALSE,"2020-03-31 13:18:13+00:00","I watched a portion of low rated (very) Morning Psycho (Joe) this Morning in order to see what Nancy Pelosi had to say, & what moves she was planning to further hurt our Country. Actually, other than her usual complaining that I’m a terrible person, she wasn’t bad. Still praying!"
"132",132,4,2,2,FALSE,"2020-03-31 11:27:06+00:00","“New York Governor Cuomo says President Trump has been “very helpful.” @foxandfriends Thank you, everybody is working very hard!"
"133",133,0,0,0,FALSE,"2020-03-30 22:24:57+00:00",""
"134",134,1,0,1,FALSE,"2020-03-30 20:50:35+00:00","White House news conference at 5:00 P.M. Eastern. Thank you!"
"135",135,0,0,0,FALSE,"2020-03-30 17:46:15+00:00",""
"136",136,5,0,5,FALSE,"2020-03-30 17:11:59+00:00","On #NationalDoctorsDay, we recognize the remarkable men & women who treat their fellow Americans, find cures for the diseases & illnesses we face, and never waver in their efforts to treat every patient with the dignity, respect, and empathy they deserve."
"137",137,0,0,0,FALSE,"2020-03-30 17:05:33+00:00",""
"138",138,2,7,-5,TRUE,"2020-03-30 11:17:10+00:00","Nancy Pelosi and the Democrats delayed the Workers Help/Stimulus Bill by over a week, trying to add real “junk” into the Bill. Got some bad things, having nothing to do with those affected by the Virus, included. Republicans need their votes until we WIN BACK THE HOUSE IN 2020!"
"139",139,5,0,5,FALSE,"2020-03-30 11:07:25+00:00","Thank you Dr. Hahn & the FDA for your fast approval of this respected Ohio company recommended by Governor @MikeDeWine. Great potential!"
"140",140,2,0,2,FALSE,"2020-03-30 05:15:37+00:00","Will be interviewed on @foxandfriends at 7:55 A.M. USA STRONG!"
"141",141,0,0,0,FALSE,"2020-03-29 23:43:14+00:00",""
"142",142,0,0,0,FALSE,"2020-03-29 23:43:07+00:00",""
"143",143,0,0,0,FALSE,"2020-03-29 20:57:55+00:00","Will be starting The White House news conference at 5:30 P.M. Eastern."
"144",144,4,0,4,TRUE,"2020-03-29 20:06:35+00:00","So proud of the @USACEHQ, @FEMA, and the Federal Government for the 2,900 bed hospital they built in 4 days (way ahead of schedule) in the Javits Center for NY. We are now moving the teams to join others so they can continue to build more hospitals/beds. Keep up the GREAT WORK!"
"145",145,3,0,3,FALSE,"2020-03-29 20:03:36+00:00","Thank you very much to Ken Langone for being a great American and for your wonderful comments on @TeamCavuto."
"146",146,3,2,1,FALSE,"2020-03-29 19:00:26+00:00","I am a great friend and admirer of the Queen & the United Kingdom. It was reported that Harry and Meghan, who left the Kingdom, would reside permanently in Canada. Now they have left Canada for the U.S. however, the U.S. will not pay for their security protection. They must pay!"
"147",147,3,0,3,FALSE,"2020-03-29 18:10:52+00:00","Happy National Vietnam War Veterans Day to all of our Vietnam era Veterans. You have earned our gratitude and thanks by your actions years ago and what you have done since returning home. The Nation thanks you and your families for your service and sacrifice. We love you!"
"148",148,2,2,0,TRUE,"2020-03-29 17:49:09+00:00","...The CBS News poll said 13 percent of Republicans trusted the news media for information about the virus.” Michael M. Grynbaum @NYTimes"
"149",149,2,0,2,FALSE,"2020-03-29 17:48:37+00:00","...alone attracted 6.2 million viewers for the president’s briefing — an astounding number for a 6 p.m. cable broadcast, more akin to the viewership for a popular prime-time sitcom..."
"150",150,0,1,-1,FALSE,"2020-03-29 17:48:37+00:00","...On Monday, nearly 12.2 million people watched Mr. Trump’s briefing on CNN, Fox News and MSNBC, according to Nielsen — ‘Monday Night Football’ numbers. Millions more are watching on ABC, CBS, NBC and online streaming sites, and the audience is expanding. On Monday, Fox News..."
"151",151,2,2,0,TRUE,"2020-03-29 17:48:36+00:00","“President Trump is a ratings hit. Since reviving the daily White House briefing Mr. Trump and his coronavirus updates have attracted an average audience of 8.5 million on cable news, roughly the viewership of the season finale of ‘The Bachelor.’ Numbers are continuing to rise..."
"152",152,1,4,-3,FALSE,"2020-03-29 17:06:20+00:00","Because the “Ratings” of my News Conferences etc. are so high, “Bachelor finale, Monday Night Football type numbers” according to the @nytimes, the Lamestream Media is going CRAZY. “Trump is reaching too many people, we must stop him.” said one lunatic. See you at 5:00 P.M.!"
"153",153,0,5,-5,TRUE,"2020-03-29 16:53:31+00:00","Polls are showing tremendous disapproval of Lamestream Media coverage of the Virus crisis. The Fake News just hasn’t figured that out yet!"
"154",154,0,2,-2,FALSE,"2020-03-29 16:34:16+00:00","The Lamestream Media wants us to fail. That will NEVER happen!"
"155",155,2,0,2,TRUE,"2020-03-29 16:12:52+00:00","Hope the FDA can approve Mask Sterilization equipment ASAP. As per Governor @MikeDeWine, there is a company in Ohio, @Battelle, which has equipment that can sterilize masks quickly."
"156",156,1,2,-1,TRUE,"2020-03-29 16:07:34+00:00","“With the Tax Cuts and new Trade Deals, we were set for a tremendous growth rate this year.... and then the Virus came along.” @larry_kudlow @MariaBartiromo We were breaking all records, especially on employment. It will all come roaring back again, and fast!"
"157",157,2,0,2,FALSE,"2020-03-29 15:13:26+00:00","Highly recommended by Governor @MikeDeWine of Ohio. @FDA must move quickly!"
"158",158,2,0,2,FALSE,"2020-03-29 14:01:57+00:00","Will be doing a press conference today at 5:00 P.M. The White House. People are working harder than I have ever seen people work. It is a beautiful thing to watch!"
"159",159,2,0,2,TRUE,"2020-03-29 00:19:31+00:00","....Federal Government. A quarantine will not be necessary. Full details will be released by CDC tonight. Thank you!"
"160",160,2,2,0,TRUE,"2020-03-29 00:19:25+00:00","On the recommendation of the White House CoronaVirus Task Force, and upon consultation with the Governor’s of New York, New Jersey and Connecticut, I have asked the @CDCgov to issue a strong Travel Advisory, to be administered by the Governors, in consultation with the...."
"161",161,6,0,6,FALSE,"2020-03-28 22:30:11+00:00","With the courage of our doctors and nurses, with the skill of our scientists and innovators, with the determination of the American People, and with the grace of God, WE WILL WIN THIS WAR. When we achieve this victory, we will emerge stronger and more united than ever before!"
"162",162,0,0,0,FALSE,"2020-03-28 18:33:19+00:00",""
"163",163,1,0,1,FALSE,"2020-03-28 17:31:58+00:00","I am giving consideration to a QUARANTINE of developing “hot spots”, New York, New Jersey, and Connecticut. A decision will be made, one way or another, shortly."
"164",164,1,0,1,FALSE,"2020-03-28 16:56:36+00:00","Heading to the Great State of Virginia now, will be there shortly. The #USNSComfort is “loaded to the gills” at Naval Station Norfolk, departing for New York City this afternoon."
"165",165,1,4,-3,FALSE,"2020-03-28 14:16:02+00:00","....very often FAKE NEWS. Lamestream Media should be forced to reveal sources, very much as they did in the long ago past. If they did that, the media would be trusted again, and Fake News would largely be a thing of the past!"
"166",166,0,3,-3,FALSE,"2020-03-28 12:33:28+00:00","One of the reasons that Fake News has become so prevalent & far reaching is the fact that corrupt “journalists” base their stories on SOURCES that they make up in order to totally distort a narrative or story. When you see, “five sources say”, don’t believe the story, it is...."
"167",167,1,4,-3,FALSE,"2020-03-28 12:13:36+00:00","So much of the Lamestream Media is writing and broadcasting stories with facts that are made up and knowingly wrong. They are doing it by quoting unnamed sources that simply do not exist. These are very dangerous & corrupt people, who will do anything to win. NAME YOUR SOURCES!"
"168",168,1,0,1,FALSE,"2020-03-28 04:49:29+00:00","Thank you James!"
"169",169,0,1,-1,FALSE,"2020-03-28 04:40:17+00:00","More Fake News!"
"170",170,3,6,-3,FALSE,"2020-03-28 04:21:32+00:00","Such Fake reporting by the @nytimes, @washingtonpost, @CNN & others. They use a small portion of a sentence out of a full paragraph in order to demean. They really are corrupt and disgusting. No wonder the media is, according to polls, record setting low & untrusted. #MAGA"
"171",171,0,0,0,FALSE,"2020-03-28 02:34:45+00:00",""
"172",172,0,0,0,FALSE,"2020-03-28 02:34:30+00:00",""
"173",173,4,2,2,TRUE,"2020-03-28 02:29:57+00:00","I love Michigan, one of the reasons we are doing such a GREAT job for them during this horrible Pandemic. Yet your Governor, Gretchen “Half” Whitmer is way in over her head, she doesn’t have a clue. Likes blaming everyone for her own ineptitude! #MAGA"
"174",174,0,1,-1,FALSE,"2020-03-28 01:05:07+00:00","She is a third rate reporter who has nothing going. A Fake News “journalist”."
"175",175,2,1,1,TRUE,"2020-03-27 21:13:10+00:00","We are marshalling the full power of government and society to achieve victory over the virus. Together, we will endure, we will prevail, and we will WIN! #CARESAct"
"176",176,4,0,4,TRUE,"2020-03-27 20:34:03+00:00","I just signed the CARES Act, the single biggest economic relief package in American History – twice as large as any relief bill ever enacted. At 2.2 Trillion Dollars, this bill will deliver urgently-needed relief for our nation’s families, workers, and businesses. #CARESAct "
"177",177,0,0,0,FALSE,"2020-03-27 20:32:53+00:00","News conference live from the @WhiteHouse today. 5:30 P.M. Eastern!"
"178",178,6,0,6,TRUE,"2020-03-27 19:57:36+00:00","Thank you to Rachel @Maddow for putting our Military on full display, and showing how GREAT a job the Federal Government is doing! Also, a special thanks to General Semonite, a Patriot of the highest order and a truly talented engineer and builder!"
"179",179,3,0,3,FALSE,"2020-03-27 16:16:24+00:00","Never knew John Kerry had such a good sense of humor! Very impressed!"
"180",180,1,0,1,TRUE,"2020-03-27 15:50:15+00:00","Thousand of Federal Government (delivered) Ventilators found in New York storage. N.Y. must distribute NOW!"
"181",181,1,4,-3,FALSE,"2020-03-27 15:45:21+00:00","Will someone please explain to the Fake News New York Times (ALL THE NEWS THAT’S NOT FIT TO PRINT) that the Democrats make it almost impossible for us to fill positions within government. They “maximum” delay even the best candidates, including Judges, leaving little time!"
"182",182,1,0,1,TRUE,"2020-03-27 15:31:33+00:00","We have just purchased many Ventilators from some wonderful companies. Names and numbers will be announced later today!"
"183",183,0,0,0,FALSE,"2020-03-27 15:29:32+00:00","Invoke “P” means Defense Production Act!"
"184",184,1,1,0,TRUE,"2020-03-27 15:23:53+00:00","General Motors MUST immediately open their stupidly abandoned Lordstown plant in Ohio, or some other plant, and START MAKING VENTILATORS, NOW!!!!!! FORD, GET GOING ON VENTILATORS, FAST!!!!!! @GeneralMotors @Ford"
"185",185,3,1,2,TRUE,"2020-03-27 15:16:07+00:00","As usual with “this” General Motors, things just never seem to work out. They said they were going to give us 40,000 much needed Ventilators, “very quickly”. Now they are saying it will only be 6000, in late April, and they want top dollar. Always a mess with Mary B. Invoke “P”."
"186",186,2,1,1,FALSE,"2020-03-27 14:29:04+00:00","Thank you Byron. Many polls are much better than this. If it is the Fake News @washingtonpost, add 10 points!"
"187",187,4,6,-2,TRUE,"2020-03-27 14:13:05+00:00","By empowering the Radical Left Democrats, do nothing Kentucky politician @RepThomasMassie is making their War on the 2nd Amendment more and more difficult to win (But don’t worry, we will win anyway!). He is a disaster for America, and for the Great State of Kentucky!"
"188",188,3,6,-3,TRUE,"2020-03-27 13:44:50+00:00","...& costly. Workers & small businesses need money now in order to survive. Virus wasn’t their fault. It is “HELL” dealing with the Dems, had to give up some stupid things in order to get the “big picture” done. 90% GREAT! WIN BACK HOUSE, but throw Massie out of Republican Party!"
"189",189,2,4,-2,FALSE,"2020-03-27 13:44:49+00:00","Looks like a third rate Grandstander named @RepThomasMassie, a Congressman from, unfortunately, a truly GREAT State, Kentucky, wants to vote against the new Save Our Workers Bill in Congress. He just wants the publicity. He can’t stop it, only delay, which is both dangerous......"
"190",190,4,5,-1,TRUE,"2020-03-27 05:19:02+00:00","Just finished a very good conversation with President Xi of China. Discussed in great detail the CoronaVirus that is ravaging large parts of our Planet. China has been through much & has developed a strong understanding of the Virus. We are working closely together. Much respect!"
"191",191,1,1,0,FALSE,"2020-03-26 23:50:02+00:00","The world is at war with a hidden enemy. WE WILL WIN!"
"192",192,5,0,5,FALSE,"2020-03-26 23:06:28+00:00","Our great Oil & Gas industry is under under seige after having one of the best years in recorded history. It will get better than ever as soon as our Country starts up again. Vital that it does for our National Security!"
"193",193,0,0,0,FALSE,"2020-03-26 20:57:15+00:00","Will be going out in 10 minutes for the press conference."
"194",194,0,0,0,FALSE,"2020-03-26 15:36:38+00:00","I will be doing a News Conference live from the @WhiteHouse at 5:00 P.M. (Eastern) to discuss the mtg of the G20 Leaders that took place this morning at 7:55 A.M. by World Teleconference. Also, my 12:00 P.M. Teleconference call w/50 Governors, plus Territories, will be discussed."
"195",195,2,0,2,FALSE,"2020-03-26 04:48:58+00:00","96-0 in the United States Senate. Congratulations AMERICA!"
"196",196,0,0,0,FALSE,"2020-03-25 23:28:33+00:00",""
"197",197,2,1,1,TRUE,"2020-03-25 21:41:27+00:00","....I have been packed all day with meetings, I have no time for stupidity. We’re working around the clock to KEEP AMERICA SAFE!"
"198",198,0,7,-7,FALSE,"2020-03-25 21:41:26+00:00","I hear that Fake News CNN just reported that I am isolated in the White House, wondering out loud, “when will life return to normal?” Does anybody really believe that? There was no leak, they made it up – they are CORRUPT & FAKE NEWS...."
"199",199,4,2,2,FALSE,"2020-03-25 20:04:56+00:00","The LameStream Media is the dominant force in trying to get me to keep our Country closed as long as possible in the hope that it will be detrimental to my election success. The real people want to get back to work ASAP. We will be stronger than ever before!"
"200",200,4,0,4,FALSE,"2020-03-25 15:45:36+00:00","Today is National #MedalofHonorDay. Join me in a #MomentofHonor to remember those who have earned our Nation's highest award for valor in combat. The Nation is eternally grateful to these patriots who so valiantly fought for America’s values and the American way of life!"
"201",201,4,0,4,FALSE,"2020-03-25 14:54:47+00:00","Congratulations to Prime Minister Abe of Japan, and the IOC, on their very wise decision to present the Olympics in 2021. It will be a great success, and I look forward to being there!"
"202",202,2,0,2,TRUE,"2020-03-25 14:49:56+00:00","The four hospitals that we (FEMA) are building in NYC at the Javits Convention Center are moving along very well, ahead of schedule. Many additional ventilators also delivered. Good conversation with Governor Cuomo!"
"203",203,2,0,2,TRUE,"2020-03-25 14:44:17+00:00","Just reported that the United States has done far more “testing” than any other nation, by far! In fact, over an eight day span, the United States now does more testing than what South Korea (which has been a very successful tester) does over an eight week span. Great job!"
"204",204,2,0,2,FALSE,"2020-03-25 12:14:57+00:00","The Democrat’s Best & Finest!"
"205",205,2,1,1,FALSE,"2020-03-25 11:47:26+00:00","Gee, that’s too bad. Such a fine guy. Presidential aspirations you know!"
"206",206,3,2,1,FALSE,"2020-03-25 11:36:48+00:00","This is really great news! I am so happy I can barely speak. He may have been a terrible presidential candidate and an even worse U.S. Senator, but he is a RINO, and I like him a lot!"
"207",207,2,2,0,TRUE,"2020-03-25 10:40:52+00:00","I am working very hard to help New York City & State. Dealing with both Mayor & Governor and producing tremendously for them, including four new medical centers and four new hospitals. Fake News that I won’t help them because I don’t like Cuomo (I do). Just sent 4000 ventilators!"
"208",208,0,3,-3,FALSE,"2020-03-25 10:14:23+00:00","“President Trump’s decision to very early on restrict travel from China saved tens of thousands of lives.” @LouDobbs @FoxBusiness"
"209",209,0,0,0,FALSE,"2020-03-24 19:50:00+00:00",""
"210",210,0,0,0,FALSE,"2020-03-24 19:31:27+00:00",""
"211",211,5,2,3,FALSE,"2020-03-24 19:08:11+00:00","Price transparency is so important for the people of our Country. In many ways, it will prove to be as important as healthcare itself. A great issue for both Republicans and Democrats. Hopefully it will be approved!"
"212",212,2,0,2,FALSE,"2020-03-24 16:04:37+00:00","Will be doing a Town Hall on @FoxNews at 12:05 P.M. (Now). I will go on around 1:00 P.M. Enjoy!"
"213",213,3,2,1,TRUE,"2020-03-24 14:16:34+00:00","Our people want to return to work. They will practice Social Distancing and all else, and Seniors will be watched over protectively & lovingly. We can do two things together. THE CURE CANNOT BE WORSE (by far) THAN THE PROBLEM! Congress MUST ACT NOW. We will come back strong!"
"214",214,2,2,0,FALSE,"2020-03-24 12:45:18+00:00","Congress must approve the deal, without all of the nonsense, today. The longer it takes, the harder it will be to start up our economy. Our workers will be hurt!"
"215",215,2,1,1,FALSE,"2020-03-24 12:04:25+00:00","This is not about the ridiculous Green New Deal. It is about putting our great workers and companies BACK TO WORK!"
"216",216,0,0,0,TRUE,"2020-03-24 12:00:33+00:00","The Defense Production Act is in full force, but haven’t had to use it because no one has said NO! Millions of masks coming as back up to States."
"217",217,1,0,1,FALSE,"2020-03-24 11:43:49+00:00","Keep Charlie Number One. Great Book!"
"218",218,1,0,1,FALSE,"2020-03-24 11:32:35+00:00","Thank you Kirstie!"
"219",219,1,0,1,FALSE,"2020-03-24 11:19:27+00:00","Buy the book and give Liz some Great Reviews! @OANN"
"220",220,2,0,2,FALSE,"2020-03-24 10:58:35+00:00","A respected coal miner and great dad! Rest In Peace!"
"221",221,0,3,-3,FALSE,"2020-03-24 10:51:45+00:00","The Media is hopeless. Too bad!"
"222",222,1,0,1,FALSE,"2020-03-24 10:48:15+00:00","Thank you Tony!"
"223",223,3,1,2,TRUE,"2020-03-24 10:14:36+00:00","The World market for face masks and ventilators is Crazy. We are helping the states to get equipment, but it is not easy. Just got 400 Ventilators for @NYCMayor Bill de Blasio. Work beginning on 4 hospitals in New York! Millions of different type items coming!"
"224",224,1,0,1,FALSE,"2020-03-24 04:16:29+00:00","This will never be approved by me, or any other Republican!"
"225",225,2,1,1,TRUE,"2020-03-24 03:43:45+00:00","The Hill/HarrisX: 61% to 39% Approval Rating on handling of Coronavirus situation. Thank you!"
"226",226,4,4,0,TRUE,"2020-03-24 03:33:07+00:00","Republicans had a deal until Nancy Pelosi rode into town from her extended vacation. The Democrats want the Virus to win? They are asking for things that have nothing to do with our great workers or companies. They want Open Borders & Green New Deal. Republicans shouldn’t agree!"
"227",227,1,5,-4,TRUE,"2020-03-24 02:44:49+00:00","....us since the beginning of this crisis.” They meant the opposite? Forgot to mention that I closed our Country to China (and Europe) very early, long before it was considered acceptable to do so. Sleepy Joe said I was “xenophobic”, but I saved thousands of lives! Fake News!"
"228",228,3,7,-4,FALSE,"2020-03-24 02:44:48+00:00","This is the way the @nytimes finished a story on me. “You can see the contrast between the steady, assured, informed and strong leadership that VP Biden (Sleepy Joe) has shown, and the bungling, chaotic and dishonest start-stop approach that Mr. (not Pres.) Trump has shown...."
"229",229,0,0,0,FALSE,"2020-03-24 00:24:59+00:00",""
"230",230,0,1,-1,FALSE,"2020-03-23 21:31:20+00:00","....is NOT their fault in any way, shape, or form. They are working closely with us to get rid of it. WE WILL PREVAIL TOGETHER!"
"231",231,3,1,2,TRUE,"2020-03-23 21:31:19+00:00","It is very important that we totally protect our Asian American community in the United States, and all around the world. They are amazing people, and the spreading of the Virus...."
"232",232,1,0,1,FALSE,"2020-03-23 16:05:53+00:00","A great early result from a drug that will start tomorrow in New York and other places! #COVIDー19"
"233",233,3,7,-4,FALSE,"2020-03-23 14:28:42+00:00","The New York Times changed headlines 3 times in order to satisfy the Radical Left. What should have been a good story got “worse & worse”, until the headline alone made it very unfair. Fake & Corrupt News that is very dangerous for our Country!"
"234",234,0,0,0,FALSE,"2020-03-23 14:16:00+00:00","THIS IS WHY WE NEED BORDERS!"
"235",235,2,0,2,FALSE,"2020-03-23 13:07:55+00:00","STRONG & UNITED, WE WILL PREVAIL! GOD BLESS THE USA!!"
"236",236,0,0,0,FALSE,"2020-03-23 13:02:30+00:00",""
"237",237,2,0,2,FALSE,"2020-03-23 11:59:50+00:00","Robert, we will end up stronger than ever before. Thank you!"
"238",238,3,0,3,FALSE,"2020-03-23 11:53:55+00:00","We will be guided by the wishes of Prime Minister Abe of Japan, a great friend of the United States and a man who has done a magnificent job on the Olympic Venue, as to attending the Olympic Games in Japan. He will make the proper decision!"
"239",239,1,2,-1,FALSE,"2020-03-23 03:50:20+00:00","WE CANNOT LET THE CURE BE WORSE THAN THE PROBLEM ITSELF. AT THE END OF THE 15 DAY PERIOD, WE WILL MAKE A DECISION AS TO WHICH WAY WE WANT TO GO!"
"240",240,1,5,-4,FALSE,"2020-03-23 03:28:00+00:00","I watch and listen to the Fake News, CNN, MSDNC, ABC, NBC, CBS, some of FOX (desperately & foolishly pleading to be politically correct), the @nytimes, & the @washingtonpost, and all I see is hatred of me at any cost. Don’t they understand that they are destroying themselves?"
"241",241,5,1,4,TRUE,"2020-03-23 01:20:08+00:00","My friend (always there when I’ve needed him!), Senator @RandPaul, was just tested “positive” from the Chinese Virus. That is not good! He is strong and will get better. Just spoke to him and he was in good spirits."
"242",242,1,2,-1,TRUE,"2020-03-22 17:32:30+00:00","The hard working men and women of @UPS are working overtime to maintain our supply chain and deliver medical supplies to those in need. Your work is critical to the health of our nation, keep it up!"
"243",243,1,4,-3,TRUE,"2020-03-22 16:14:59+00:00",".@JBPritzker, Governor of Illinois, and a very small group of certain other Governors, together with Fake News @CNN & Concast (MSDNC), shouldn’t be blaming the Federal Government for their own shortcomings. We are there to back you up should you fail, and always will be!"
"244",244,1,0,1,FALSE,"2020-03-22 14:52:09+00:00","Working very well with States and our Nation’s Governors. #TEAMWORK"
"245",245,2,1,1,TRUE,"2020-03-22 14:49:27+00:00","Thank you to Fred Smith and @FedEx for the rapid emergency deliveries you are making all over our Nation. Keep it going!"
"246",246,2,0,2,TRUE,"2020-03-22 14:25:16+00:00","Ford, General Motors and Tesla are being given the go ahead to make ventilators and other metal products, FAST! @fema Go for it auto execs, lets see how good you are? @RepMarkMeadows @GOPLeader @senatemajldr"
"247",247,0,0,0,FALSE,"2020-03-22 10:11:38+00:00","So true!"
"248",248,1,0,1,FALSE,"2020-03-22 10:07:25+00:00","That doesn’t sound like Michael, does it?"
"249",249,1,0,1,FALSE,"2020-03-22 10:03:36+00:00","Maria is Great!"
"250",250,0,0,0,FALSE,"2020-03-22 03:56:31+00:00",""
"251",251,1,0,1,FALSE,"2020-03-22 03:46:46+00:00","Thank you @JennPellegrino @OANN"
"252",252,1,0,1,FALSE,"2020-03-22 03:19:31+00:00","Thank you David, so true!"
"253",253,1,0,1,FALSE,"2020-03-22 03:14:05+00:00","Thank you!"
"254",254,0,1,-1,TRUE,"2020-03-22 02:53:27+00:00","CHINESE VIRUS FACT CHECK"
"255",255,0,0,0,FALSE,"2020-03-21 20:55:14+00:00",""
"256",256,0,0,0,FALSE,"2020-03-21 20:38:21+00:00",""
"257",257,2,1,1,TRUE,"2020-03-21 14:13:09+00:00","....be put in use IMMEDIATELY. PEOPLE ARE DYING, MOVE FAST, and GOD BLESS EVERYONE! @US_FDA @SteveFDA @CDCgov @DHSgov"
"258",258,4,0,4,TRUE,"2020-03-21 14:13:08+00:00","HYDROXYCHLOROQUINE & AZITHROMYCIN, taken together, have a real chance to be one of the biggest game changers in the history of medicine. The FDA has moved mountains - Thank You! Hopefully they will BOTH (H works better with A, International Journal of Antimicrobial Agents)....."
"259",259,2,0,2,FALSE,"2020-03-21 13:21:10+00:00","Great story. Thank you to Mr. Young of Jonesboro, Arkansas!"
"260",260,0,0,0,FALSE,"2020-03-21 01:58:56+00:00",""
"261",261,0,0,0,FALSE,"2020-03-21 01:58:17+00:00",""
"262",262,4,1,3,TRUE,"2020-03-20 20:22:12+00:00","Today I spoke with our Nation’s Small Businesses, which employ nearly half of America’s workforce. We are taking the MOST aggressive action in history to deliver fast relief to your businesses and workers. We will always protect our Small Businesses! @SBAgov"
"263",263,0,0,0,FALSE,"2020-03-20 18:45:23+00:00",""
"264",264,1,0,1,FALSE,"2020-03-20 04:41:00+00:00","A Great Guy!"
"265",265,2,3,-1,FALSE,"2020-03-20 04:37:18+00:00","Steve is one of the very best in the Senate. He is competing against a failed Democrat Presidential candidate who never got close to 1%, and was sent packing. Had to be talked into this run by Schumer. Bad for 2nd A! I strongly Endorse @SteveDaines!"
"266",266,0,0,0,FALSE,"2020-03-19 23:31:33+00:00",""
"267",267,2,0,2,TRUE,"2020-03-19 22:23:48+00:00","America’s Private Sector is stepping up to help us be STRONG! Many of the Nation’s distillers, large and small, are producing and donating hand sanitizer to help fight #COVID19. THANK YOU!"
"268",268,5,1,4,TRUE,"2020-03-19 22:16:29+00:00","THANK YOU to our Police Officers, Fire Fighters, and EMS who help us defeat the Virus every day. Our proud nation is grateful for the unwavering dedication and sacrifice of our First Responders and their families. TOGETHER we will beat this!"
"269",269,1,0,1,FALSE,"2020-03-19 22:13:19+00:00","THANK YOU! #ThankATrucker"
"270",270,0,0,0,TRUE,"2020-03-19 14:24:39+00:00","SOCIAL DISTANCING!"
"271",271,1,0,1,FALSE,"2020-03-19 12:54:47+00:00","We are going to WIN, sooner rather than later!"
"272",272,1,0,1,FALSE,"2020-03-18 21:48:42+00:00","STRONG & UNITED, WE WILL PREVAIL!"
"273",273,0,2,-2,TRUE,"2020-03-18 21:37:22+00:00","I only signed the Defense Production Act to combat the Chinese Virus should we need to invoke it in a worst case scenario in the future. Hopefully there will be no need, but we are all in this TOGETHER!"
"274",274,1,0,1,FALSE,"2020-03-18 20:50:43+00:00","Thank you @HerschelWalker!"
"275",275,4,0,4,FALSE,"2020-03-18 20:49:33+00:00","Today I spoke with American physicians and nurses to thank them for their tireless work. Doctors and nurses are at the front lines of this war and are true American HEROES! With their help, America will WIN."
"276",276,2,0,2,FALSE,"2020-03-18 19:14:46+00:00","...It cannot overcome the dedication of our doctors, nurses, and scientists — and it cannot beat the LOVE, PATRIOTISM, and DETERMINATION of our citizens. Strong and United, WE WILL PREVAIL!"
"277",277,0,3,-3,FALSE,"2020-03-18 19:14:46+00:00","I want all Americans to understand: we are at war with an invisible enemy, but that enemy is no match for the spirit and resolve of the American people..."
"278",278,0,1,-1,TRUE,"2020-03-18 18:40:10+00:00","15 DAYS TO SLOW THE SPREAD!"
"279",279,3,1,2,TRUE,"2020-03-18 15:45:55+00:00","Thank you to our great American businesses for going above and beyond to keep our most vulnerable citizens safe!"
"280",280,0,0,0,TRUE,"2020-03-18 13:37:46+00:00","We will be, by mutual consent, temporarily closing our Northern Border with Canada to non-essential traffic. Trade will not be affected. Details to follow!"
"281",281,1,3,-2,FALSE,"2020-03-18 13:30:02+00:00","....Also, according to the Daily Caller, leading Sleepy Joe Biden in Florida, 48% to 42%."
"282",282,2,9,-7,FALSE,"2020-03-18 13:29:58+00:00","95% Approval Rating in the Republican Party, 53% overall. Not bad considering I get nothing but Fake & Corrupt News, day and night. “Russia, Russia, Russia”, then “the Ukraine Scam (where’s the Whistleblower?)”, the “Impeachment Hoax”, and more, more, more...."
"283",283,4,3,1,FALSE,"2020-03-18 13:16:07+00:00","The DNC will have gotten their fondest wish and defeated Bernie Sanders, far ahead of schedule. Now they are doing everything possible to be nice to him in order to keep his supporters. Bernie has given up, just like he did last time. He will be dropping out soon! MAGA/KAG"
"284",284,1,5,-4,TRUE,"2020-03-18 11:46:33+00:00","I always treated the Chinese Virus very seriously, and have done a very good job from the beginning, including my very early decision to close the “borders” from China - against the wishes of almost all. Many lives were saved. The Fake News new narrative is disgraceful & false!"
"285",285,1,1,0,TRUE,"2020-03-18 11:12:49+00:00","I will be having a news conference today to discuss very important news from the FDA concerning the Chinese Virus!"
"286",286,1,0,1,FALSE,"2020-03-18 10:53:58+00:00","I will totally protect your Medicare & Social Security!"
"287",287,3,3,0,TRUE,"2020-03-18 10:41:14+00:00","For the people that are now out of work because of the important and necessary containment policies, for instance the shutting down of hotels, bars and restaurants, money will soon be coming to you. The onslaught of the Chinese Virus is not your fault! Will be stronger than ever!"
"288",288,0,0,0,FALSE,"2020-03-17 20:12:55+00:00",""
"289",289,1,1,0,FALSE,"2020-03-17 19:31:33+00:00","The world is at war with a hidden enemy. WE WILL WIN!"
"290",290,3,0,3,TRUE,"2020-03-17 13:34:01+00:00","Federal Government is working very well with the Governors and State officials. Good things will happen! #KILLTHEVIRUS"
"291",291,2,1,1,FALSE,"2020-03-17 13:27:18+00:00","Failing Michigan Governor must work harder and be much more proactive. We are pushing her to get the job done. I stand with Michigan!"
"292",292,0,2,-2,TRUE,"2020-03-17 12:22:11+00:00","Cuomo wants “all states to be treated the same.” But all states aren’t the same. Some are being hit hard by the Chinese Virus, some are being hit practically not at all. New York is a very big “hotspot”, West Virginia has, thus far, zero cases. Andrew, keep politics out of it...."
"293",293,0,1,-1,FALSE,"2020-03-17 03:27:51+00:00","The “Times” is a disgrace to journalism!"
"294",294,1,0,1,FALSE,"2020-03-17 03:19:49+00:00","Great news Lindsey!"
"295",295,4,1,3,TRUE,"2020-03-16 22:51:54+00:00","The United States will be powerfully supporting those industries, like Airlines and others, that are particularly affected by the Chinese Virus. We will be stronger than ever before!"
"296",296,2,1,1,TRUE,"2020-03-16 20:29:46+00:00","I ask all Americans to band together and support your neighbors by not hoarding unnecessary amounts of food and essentials. TOGETHER we will stay STRONG and overcome this challenge!"
"297",297,2,1,1,TRUE,"2020-03-16 20:29:30+00:00","Yesterday I spoke with the great American Grocers and Supply Chain Executives. We are confident that supply will continue to meet demand nationwide. These beacons of our community will remain open for you, no matter what. We are working hard to remove any barriers to that effort!"
"298",298,0,0,0,FALSE,"2020-03-16 20:16:34+00:00",""
"299",299,0,0,0,FALSE,"2020-03-16 20:16:23+00:00",""
"300",300,2,0,2,FALSE,"2020-03-16 18:32:44+00:00","Just had a very good tele-conference with Nation’s Governors. Went very well. Cuomo of New York has to “do more”."
"301",301,6,1,5,FALSE,"2020-03-16 15:00:41+00:00","Everybody is so well unified and working so hard. It is a beautiful thing to see. They love our great Country. We will end up being stronger than ever before!"
"302",302,1,0,1,FALSE,"2020-03-16 12:41:22+00:00","God Bless the USA!"
"303",303,0,0,0,FALSE,"2020-03-16 03:34:33+00:00",""
"304",304,0,3,-3,FALSE,"2020-03-16 02:51:02+00:00","I must say, that was a VERY boring debate. Biden lied when he said I want to cut Social Security and Medicare. That’s what they ALL said 4 years ago, and nothing happened, in fact, I saved Social Security and Medicare. I will not be cutting, but they will. Be careful!"
"305",305,1,0,1,TRUE,"2020-03-15 22:53:05+00:00","The individual Governors of States, and local officials, must step up their efforts on drive up testing and testing sights, working in conjunction with @CDCgov and the Federal Government!"
"306",306,2,2,0,FALSE,"2020-03-15 18:08:35+00:00","The Fake and Corrupt News never called Google. They said this was not true. Even in times such as these, they are not truthful. Watch for their apology, it won’t happen. More importantly, thank you to Google!"
"307",307,3,1,2,FALSE,"2020-03-15 17:29:03+00:00","So now it is reported that, after destroying his life & the life of his wonderful family (and many others also), the FBI, working in conjunction with the Justice Department, has “lost” the records of General Michael Flynn. How convenient. I am strongly considering a Full Pardon!"
"308",308,4,2,2,FALSE,"2020-03-15 17:09:50+00:00","Can’t believe they are not going after Schumer for the threats he made to our cherished United States Supreme Court, and our two great Justices. If a Republican did that, there would be an endless price to pay. Pathetic!"
"309",309,1,4,-3,TRUE,"2020-03-15 17:02:00+00:00","....The USA was never set up for this, just look at the catastrophe of the H1N1 Swine Flu (Biden in charge, 17,000 people lost, very late response time), but it soon will be. Great decision to close our China, and other, borders early. Saved many lives!"
"310",310,2,2,0,TRUE,"2020-03-15 17:02:00+00:00","There will be a News Conference by the CoronaVirus Task Force today at the White House, 5 P.M. @VP We are working closely with the Governors of our Country’s great States, which are a very big factor. They are working hard, along with us, to get the job properly done....."
"311",311,6,2,4,TRUE,"2020-03-15 16:34:23+00:00","We are doing very precise Medical Screenings at our airports. Pardon the interruptions and delays, we are moving as quickly as possible, but it is very important that we be vigilant and careful. We must get it right. Safety first!"
"312",312,3,0,3,FALSE,"2020-03-15 15:20:33+00:00","I am watching a great and beautiful service by Pastor Jentezen Franklin. Thank you! @Jentezen"
"313",313,1,0,1,FALSE,"2020-03-15 15:02:16+00:00","TODAY IS A NATIONAL DAY OF PRAYER. GOD BLESS EVERYONE!"
"314",314,3,1,2,FALSE,"2020-03-15 14:58:31+00:00","Great Job by Judicial Watch. Potentially a treasure trove. Too bad you are not given more help, but it will all work out!"
"315",315,0,1,-1,FALSE,"2020-03-15 14:49:20+00:00","This took place in the Rose Garden, just coming out of a cold Winter!"
"316",316,1,2,-1,FALSE,"2020-03-15 14:45:29+00:00","Amazing how the Fake News never covers this. No Interest on Student Loans. The Dems are just talk!"
"317",317,3,0,3,FALSE,"2020-03-15 14:42:54+00:00","Thank you Sara. Keep writing, great talent!"
"318",318,1,0,1,FALSE,"2020-03-15 14:35:37+00:00","Thank you!"
"319",319,0,0,0,FALSE,"2020-03-15 01:49:27+00:00",""
"320",320,1,0,1,FALSE,"2020-03-14 23:03:49+00:00","Tomorrow I have called for a National Day of Prayer. I will be tuning in to Pastor @Jentezen at the @FreeChapel Church in Gainesville, Georgia at 11:00 AM EDT. God Bless the USA! http://freechapel.org/live"
"321",321,1,1,0,TRUE,"2020-03-14 19:13:34+00:00","The @CDCgov has published guidelines on http://CoronaVirus.gov to enable every American to respond to this epidemic and to protect themselves, their families and their communities."
"322",322,4,0,4,FALSE,"2020-03-14 19:06:09+00:00","Just had a nice conversation with Prime Minister @JustinTrudeau of Canada. Great to hear that his wonderful wife Sophie is doing very well. The United States and Canada will continue to coordinate closely together on COVID-19."
"323",323,0,0,0,FALSE,"2020-03-14 18:20:05+00:00",""
"324",324,0,0,0,FALSE,"2020-03-14 17:54:49+00:00","COVID-19 UPDATE"
"325",325,1,0,1,FALSE,"2020-03-14 17:31:56+00:00","THE UNITED STATES LOVES ITALY!"
"326",326,0,0,0,FALSE,"2020-03-14 16:14:08+00:00","Just finished a meeting on Covid-19 in the Situation Room, news conference coming up shortly. https://twitter.com/realDonaldTrump/status/1238823680735612930"
"327",327,0,0,0,FALSE,"2020-03-14 15:57:29+00:00","News Conference at White House in 10 minutes."
"328",328,0,0,0,TRUE,"2020-03-14 13:47:24+00:00","SOCIAL DISTANCING!"
"329",329,1,0,1,FALSE,"2020-03-14 13:45:56+00:00","Attending meetings on Covid-19 in the White House. Working with States and local governments, many of whom have done a great job. Full report latter!"
"330",330,1,0,1,FALSE,"2020-03-14 12:08:12+00:00","BIGGEST STOCK MARKET RISE IN HISTORY YESTERDAY!"
"331",331,2,0,2,FALSE,"2020-03-14 12:02:56+00:00","Larry, I am not surprised that Candace was great. I would only be surprised if she wasn’t great!"
"332",332,4,2,2,TRUE,"2020-03-14 11:37:24+00:00","Good teamwork between Republicans & Democrats as the House passes the big CoronaVirus Relief Bill. People really pulled together. Nice to see!"
"333",333,2,3,-1,TRUE,"2020-03-14 01:27:54+00:00","To those families and citizens who are worried and concerned for themselves and their loved ones, I want you to know that your Federal Government will unleash every authority, resource and tool at its disposal to safeguard the lives and health of our people."
"334",334,1,0,1,TRUE,"2020-03-14 00:42:32+00:00","....the health and well-being of American families FIRST. Look forward to signing the final Bill, ASAP!"
"335",335,3,3,0,FALSE,"2020-03-14 00:42:32+00:00","....the Secretary of the Treasury and the Secretary of Labor to issue regulations that will provide flexibility so that in no way will Small Businesses be hurt. I encourage all Republicans and Democrats to come together and VOTE YES! I will always put...."
"336",336,2,3,-1,TRUE,"2020-03-14 00:42:25+00:00","I fully support H.R. 6201: Families First CoronaVirus Response Act, which will be voted on in the House this evening. This Bill will follow my direction for free CoronaVirus tests, and paid sick leave for our impacted American workers. I have directed...."
"337",337,2,1,1,FALSE,"2020-03-13 23:10:37+00:00","Americans are the strongest and most resilient people on earth...We will remove or eliminate every obstacle necessary to deliver our people the care that they need, and that they are entitled to. No resource will be spared."
"338",338,2,0,2,FALSE,"2020-03-13 22:54:37+00:00","....No matter where you may be, I encourage you to turn towards prayer in an act of faith. Together, we will easily PREVAIL!"
"339",339,6,0,6,FALSE,"2020-03-13 22:54:36+00:00","It is my great honor to declare Sunday, March 15th as a National Day of Prayer. We are a Country that, throughout our history, has looked to God for protection and strength in times like these...."
"340",340,3,0,3,FALSE,"2020-03-13 22:21:18+00:00","At my request, effective midnight tonight, Carnival, Royal Caribbean, Norwegian, and MSC have all agreed to suspend outbound cruises for thirty days. It is a great and important industry – it will be kept that way!"
"341",341,0,1,-1,FALSE,"2020-03-13 21:19:39+00:00","We will remove or eliminate every obstacle necessary to deliver our people the care they need. No resource will be spared!"
"342",342,1,2,-1,TRUE,"2020-03-13 21:00:16+00:00","To unleash the full power of the Federal Government in this effort, today I am officially declaring a National Emergency."
"343",343,0,1,-1,TRUE,"2020-03-13 14:55:34+00:00","I will be having a news conference today at 3:00 P.M., The White House. Topic: CoronaVirus!"
"344",344,1,2,-1,TRUE,"2020-03-13 14:52:59+00:00","To this point, and because we have had a very strong border policy, we have had 40 deaths related to CoronaVirus. If we had weak or open borders, that number would be many times higher!"
"345",345,2,1,1,TRUE,"2020-03-13 13:44:29+00:00","The Federal Reserve must FINALLY lower the Fed Rate to something comparable to their competitor Central Banks. Jay Powell and group are putting us at a decided economic & physiological disadvantage. Should never have been this way. Also, STIMULATE!"
"346",346,4,0,4,FALSE,"2020-03-13 12:30:48+00:00","If you want to get money into the hands of people quickly & efficiently, let them have the full money that they earned, APPROVE A PAYROLL TAX CUT until the end of the year, December 31. Then you are doing something that is really meaningful. Only that will make a big difference!"
"347",347,2,3,-1,TRUE,"2020-03-13 10:22:19+00:00",".... Their response to H1N1 Swine Flu was a full scale disaster, with thousands dying, and nothing meaningful done to fix the testing problem, until now. The changes have been made and testing will soon happen on a very large scale basis. All Red Tape has been cut, ready to go!"
"348",348,0,4,-4,TRUE,"2020-03-13 10:22:17+00:00","For decades the @CDCgov looked at, and studied, its testing system, but did nothing about it. It would always be inadequate and slow for a large scale pandemic, but a pandemic would never happen, they hoped. President Obama made changes that only complicated things further....."
"349",349,0,8,-8,TRUE,"2020-03-13 02:33:48+00:00","“The Obama White House had to immediately issue an apology for Joe Biden’s remarks, and any alarm that he might have caused, an alarm about a Swine Flu outbreak that took 6 months for President Obama to declare a National Emergency, and that killed 12,000 Americans.” @LouDobbs"
"350",350,5,6,-1,TRUE,"2020-03-13 02:20:56+00:00","Sleepy Joe Biden was in charge of the H1N1 Swine Flu epidemic which killed thousands of people. The response was one of the worst on record. Our response is one of the best, with fast action of border closings & a 78% Approval Rating, the highest on record. His was lowest!"
"351",351,6,0,6,FALSE,"2020-03-13 01:58:02+00:00","Just had a great conversation with Prime Minister Abe of Japan. I told him that the just completed Olympic venue is magnificent. He has done an incredible job, one that will make him very proud. Good things will happen for Japan and their great Prime Minister. Lots of options!"
"352",352,1,2,-1,TRUE,"2020-03-12 20:02:21+00:00","108 countries are dealing with the CoronaVirus problem, some of which we are helping!"
"353",353,2,0,2,TRUE,"2020-03-12 18:02:02+00:00","KEEPING THE WORKPLACE SAFE, ENCOURAGE YOUR EMPLOYEES TO...."
"354",354,2,0,2,TRUE,"2020-03-12 18:02:00+00:00","KEEPING COMMERCIAL ESTABLISHMENTS SAFE, ENCOURAGE YOUR EMPLOYEES AND CUSTOMERS TO...."
"355",355,2,0,2,TRUE,"2020-03-12 18:01:57+00:00","KEEPING THE SCHOOL SAFE, ENCOURAGE YOUR FACULTY, STAFF, AND STUDENTS TO...."
"356",356,2,0,2,TRUE,"2020-03-12 18:01:55+00:00","KEEPING THE HOME SAFE, ENCOURAGE YOUR FAMILY MEMBERS TO...."
"357",357,2,2,0,FALSE,"2020-03-12 14:44:36+00:00","Many Republican Senators want me to Veto the FISA Bill until we find out what led to, and happened with, the illegal attempted “coup” of the duly elected President of the United States, and others!"
"358",358,4,2,2,FALSE,"2020-03-12 10:15:43+00:00","“Nancy Pelosi all of a sudden doesn’t like the payroll tax cut, but when Obama proposed it she thought it was a brilliant thing that all of the working families would benefit from because if you get a paycheck, you’re going to take home more money.” @kilmeade @foxandfriends"
"359",359,2,3,-1,FALSE,"2020-03-12 02:13:32+00:00","Hoping to get the payroll tax cut approved by both Republicans and Democrats, and please remember, very important for all countries & businesses to know that trade will in no way be affected by the 30-day restriction on travel from Europe. The restriction stops people not goods."
"360",360,0,0,0,FALSE,"2020-03-12 02:11:12+00:00",""
"361",361,4,4,0,TRUE,"2020-03-11 22:04:26+00:00","The Media should view this as a time of unity and strength. We have a common enemy, actually, an enemy of the World, the CoronaVirus. We must beat it as quickly and safely as possible. There is nothing more important to me than the life & safety of the United States!"
"362",362,0,0,0,FALSE,"2020-03-11 20:44:36+00:00","I will be addressing the Nation this evening at 9:00 P.M. (Eastern) from the Oval Office."
"363",363,1,1,0,TRUE,"2020-03-11 19:18:35+00:00","I am fully prepared to use the full power of the Federal Government to deal with our current challenge of the CoronaVirus!"
"364",364,1,0,1,FALSE,"2020-03-11 19:17:50+00:00","....We have the greatest healthcare system, experts, scientists and doctors anywhere in the world. Together, we will PREVAIL!"
"365",365,4,2,2,TRUE,"2020-03-11 19:17:50+00:00","I want to thank all of our Great Government officials on the CoronaVirus Task Force who are working around the clock, in response to the CoronaVirus. Continue to check http://CDC.gov for updates, and follow all recommendations that are available...."
"366",366,2,1,1,TRUE,"2020-03-11 18:52:45+00:00","....Together we are putting into policy a plan to prevent, detect, treat and create a vaccine against CoronaVirus to save lives in America and the world. America will get it done!"
"367",367,6,0,6,TRUE,"2020-03-11 18:52:44+00:00","America is the Greatest Country in the world. We have the best scientists, doctors, nurses and health care professionals. They are amazing people who do phenomenal things every day...."
"368",368,1,2,-1,TRUE,"2020-03-11 18:50:10+00:00","Someone needs to tell the Democrats in Congress that CoronaVirus doesn’t care what party you are in. We need to protect ALL Americans!"
"369",369,2,5,-3,TRUE,"2020-03-11 14:22:00+00:00","Vanity Fair Magazine, which will soon be out of business, and their third rate Fake reporters, who make up sources which don’t exist, wrote yet another phony & boring hit piece. The facts are just the opposite. Our team is doing a great job with CoronaVirus!"
"370",370,2,0,2,FALSE,"2020-03-11 14:08:11+00:00","Thank you Gavin. Team is doing a great job!"
"371",371,2,0,2,FALSE,"2020-03-11 05:32:35+00:00","THANK YOU IDAHO! #KAG2020"
"372",372,1,8,-7,FALSE,"2020-03-11 04:55:59+00:00","Pocahontas, working in conjunction with the Democrat Party, totally destroyed the campaign of Bernie Sanders. If she would have quit 3 days earlier, Sanders would have beaten Biden in a route, it wouldn’t even have been close. They also got two other losers to support Sleepy Joe!"
"373",373,2,0,2,FALSE,"2020-03-11 03:28:10+00:00","THANK YOU WASHINGTON! #KAG2020"
"374",374,2,0,2,FALSE,"2020-03-11 03:27:42+00:00","THANK YOU NORTH DAKOTA! #KAG2020"
"375",375,7,2,5,FALSE,"2020-03-11 01:54:14+00:00","....(which is under siege), is strong on Crime and the Border, and truly LOVES our Military and our Vets. He will be a great Senator for the people of Alabama. Coach Tommy Tuberville, a winner, has my Complete and Total Endorsement. I love Alabama!"
"376",376,5,0,5,FALSE,"2020-03-11 01:54:13+00:00","Tommy Tuberville (@TTuberville) is running for the U.S. Senate from the Great State of Alabama. Tommy was a terrific head football coach at Auburn University. He is a REAL LEADER who will never let MAGA/KAG, or our Country, down! Tommy will protect your Second Amendment...."
"377",377,2,0,2,FALSE,"2020-03-11 01:07:05+00:00","THANK YOU MICHIGAN! #KAG2020"
"378",378,2,0,2,FALSE,"2020-03-11 00:55:26+00:00","THANK YOU MISSOURI! #KAG2020"
"379",379,2,0,2,FALSE,"2020-03-11 00:52:39+00:00","THANK YOU MISSISSIPPI! #KAG2020"
"380",380,6,1,5,FALSE,"2020-03-10 21:59:35+00:00","Best unemployment numbers in the history of our Country. Best employment number EVER, almost 160 million people working right now. Vote Republican, unless you want to see these numbers obliterated!"
"381",381,2,1,1,FALSE,"2020-03-10 21:31:54+00:00","If you like automobiles, how can you vote for a Democrat who all want to get rid of cars, as quickly as possible, especially if they are powered by gasoline. Remember also, no more than one car per family. I, on the other hand, have new plants being built all over Michigan, Plus!"
"382",382,1,0,1,FALSE,"2020-03-10 18:41:08+00:00","Great meeting on Capitol Hill with the @SenateGOP!"
"383",383,1,0,1,FALSE,"2020-03-10 16:44:33+00:00","Thank you @SenateGOP!"
"384",384,3,0,3,FALSE,"2020-03-10 14:48:18+00:00","Ronald Reagan’s great economist, the recipient of the Presidential Medal of Freedom, has just said great things about a Payroll Tax Cut!"
"385",385,2,2,0,TRUE,"2020-03-10 14:44:11+00:00","Our CoronaVirus Team has been doing a great job. Even Democrat governors have been VERY complimentary!"
"386",386,1,3,-2,FALSE,"2020-03-10 14:42:24+00:00","Nancy Pelosi just said, “I don’t know if we can be ready this week.” In other words, it’s off to vacation for the Do Nothing Democrats. That’s been the story with them for 1 1/2 years!"
"387",387,0,6,-6,FALSE,"2020-03-10 14:28:57+00:00","There is another Russia, Russia, Russia meeting today. It is headed up by corrupt politician Adam “Shifty” Schiff, so I wouldn’t expect too much! @DHS_Wolf"
"388",388,1,0,1,TRUE,"2020-03-10 14:02:12+00:00","The Federal Reserve must be a leader, not a very late follower, which it has been!"
"389",389,4,2,2,TRUE,"2020-03-10 14:00:07+00:00","Our pathetic, slow moving Federal Reserve, headed by Jay Powell, who raised rates too fast and lowered too late, should get our Fed Rate down to the levels of our competitor nations. They now have as much as a two point advantage, with even bigger currency help. Also, stimulate!"
"390",390,3,0,3,FALSE,"2020-03-10 13:48:19+00:00","Well deserved Jack. A great honor!"
"391",391,1,0,1,FALSE,"2020-03-10 13:46:15+00:00","True, with number 1 being more important!"
"392",392,0,3,-3,FALSE,"2020-03-10 13:23:21+00:00","Going to be a BAD day for Crazy Bernie!"
"393",393,1,1,0,FALSE,"2020-03-10 11:36:36+00:00","Polls say they BOTH lose to “Trump”."
"394",394,4,2,2,FALSE,"2020-03-10 11:33:52+00:00","Wow! @foxandfriends blew away the competition of Morning Joke (which did very poorly) on MSDNC (Another Comcast sleaze production), and @CNN’s New Day, in the Morning Television Ratings. A total blowout, but that’s what you get when you treat “Trump” fairly!"
"395",395,1,1,0,FALSE,"2020-03-10 11:08:03+00:00","Going up fast. We need the Wall more than ever!"
"396",396,0,1,-1,FALSE,"2020-03-10 04:49:44+00:00","Fake News!!"
"397",397,2,0,2,FALSE,"2020-03-10 04:38:20+00:00","Oklahoma, Vote for your GREAT Senator Today. Nobody better than Jim!"
"398",398,6,0,6,FALSE,"2020-03-09 21:36:08+00:00","THANK YOU, Jim, for your incredible support of our #MAGA Agenda! You are a tremendous Senator for the people of the Great State of Oklahoma and you have my Complete and Total Endorsement!"
"399",399,8,0,8,FALSE,"2020-03-09 21:34:37+00:00","Congressman @StevenPalazzo is doing a fantastic job for the people of Mississippi. He strongly supports our #MAGA Agenda. Steven will continue to protect your #2A, & Support our INCREDIBLE Vets & Military. Steven has my Complete Endorsement. VOTE for Steven tomorrow, March 10th!"
"400",400,6,1,5,FALSE,"2020-03-09 21:29:35+00:00","Congressman Michael Guest (@GuestCongress) is an incredible fighter for the Great State of Mississippi. Michael is strong on Crime and the Border, he loves our Military and Vets. Michael has my Complete and Total Endorsement! Get out and Vote for Michael tomorrow, March 10th!"
"401",401,1,2,-1,TRUE,"2020-03-09 14:47:59+00:00","So last year 37,000 Americans died from the common Flu. It averages between 27,000 and 70,000 per year. Nothing is shut down, life & the economy go on. At this moment there are 546 confirmed cases of CoronaVirus, with 22 deaths. Think about that!"
"402",402,0,2,-2,FALSE,"2020-03-09 14:36:50+00:00","Saudi Arabia and Russia are arguing over the price and flow of oil. That, and the Fake News, is the reason for the market drop!"
"403",403,1,0,1,FALSE,"2020-03-09 14:36:49+00:00","Good for the consumer, gasoline prices coming down!"
"404",404,0,1,-1,FALSE,"2020-03-09 13:17:12+00:00","So much FAKE NEWS!"
"405",405,2,1,1,FALSE,"2020-03-09 13:16:05+00:00","The BEST decision made was the toughest of them all - which saved many lives. Our VERY early decision to stop travel to and from certain parts of the world!"
"406",406,2,1,1,TRUE,"2020-03-09 13:11:47+00:00","Great job being done by the @VP and the CoronaVirus Task Force. Thank you!"
"407",407,2,2,0,FALSE,"2020-03-09 11:40:56+00:00","The Obama/Biden Administration is the most corrupt Administration in the history of our Country!"
"408",408,4,4,0,FALSE,"2020-03-09 11:39:35+00:00","“Trump has outmastered the Deep State. He’s light years ahead of us.” MSDNC. I disagree. We have a long way to go. There are still some very bad, sick people in our government - people who do not love our Country (In fact, they hate our Country!)."
"409",409,0,7,-7,FALSE,"2020-03-09 11:33:37+00:00","Now the Democrats are trying to smear Bernie with Russia, Russia, Russia. They are driving him Crazy!"
"410",410,2,5,-3,FALSE,"2020-03-09 11:30:18+00:00","Elizabeth “Pocahontas” Warren singlehandedly destroyed the Bernie Sanders campaign by stripping voters away from his count on Super T. He lost states that he easily would have won if she had dropped out 3 days earlier. The DNC is doing it to Bernie again! Will he ever get angry?"
"411",411,1,4,-3,FALSE,"2020-03-09 11:24:52+00:00","Cryin’ Chuck Schumer said, “You will pay the price for this. You won’t know what HIT YOU.” That is far beyond simple rhetoric. That is a physical threat, or at least a threat that you better vote for us.” Trouble ahead!"
"412",412,0,6,-6,TRUE,"2020-03-09 11:20:43+00:00","The Fake News Media and their partner, the Democrat Party, is doing everything within its semi-considerable power (it used to be greater!) to inflame the CoronaVirus situation, far beyond what the facts would warrant. Surgeon General, “The risk is low to the average American.”"
"413",413,2,0,2,FALSE,"2020-03-09 11:10:47+00:00","A great book, support Charlie, BUY IT! Already Number One."
"414",414,0,1,-1,FALSE,"2020-03-09 10:17:11+00:00","Working hard Lori!"
"415",415,1,0,1,FALSE,"2020-03-09 05:25:11+00:00","There are no mixed messages, only political weaponization by people like you and your brother, Fredo!"
"416",416,1,0,1,FALSE,"2020-03-08 22:18:35+00:00","Who knows what this means, but it sounds good to me!"
"417",417,0,5,-5,FALSE,"2020-03-08 16:23:39+00:00","The New York Times is an embarrassment to journalism. They were a dead paper before I went into politics, and they will be a dead paper after I leave, which will be in 5 years. Fake News is the Enemy of the people!"
"418",418,4,6,-2,TRUE,"2020-03-08 12:45:45+00:00","We have a perfectly coordinated and fine tuned plan at the White House for our attack on CoronaVirus. We moved VERY early to close borders to certain areas, which was a Godsend. V.P. is doing a great job. The Fake News Media is doing everything possible to make us look bad. Sad!"
"419",419,1,0,1,FALSE,"2020-03-08 05:24:08+00:00","Thank you @SenatorTimScott!"
"420",420,2,5,-3,FALSE,"2020-03-08 04:42:08+00:00",".....least 5 States & the Nomination. Did the DNC & Dems tell Elizabeth Warren to wait? If so, they were deadly, the race would have been over, & Bernie would have won. Dirty double dealing? Nobody knows for sure, & history will be the judge. But I say, here we go AGAIN, Bernie!"
"421",421,1,6,-5,FALSE,"2020-03-08 04:42:07+00:00","We have now learned for sure that the Democrats don’t want anything to do with Crazy Bernie. Rigged? First @amyklobuchar & @PeteButtigieg quit the race & come out for Sleepy Joe BEFORE Super Tuesday. Pocahontas says NO & quits race AFTER ELECTION, thereby depriving Bernie of at.."
"422",422,0,1,-1,FALSE,"2020-03-08 03:56:39+00:00","I agree with Joe!"
"423",423,2,0,2,FALSE,"2020-03-08 03:47:31+00:00","Thank you to the Great State of Tennessee. We are with you all the way!"
"424",424,2,0,2,FALSE,"2020-03-07 03:45:41+00:00","Thank you @GovBillLee and @MariaLeeTN. My Administration will always be there for the Great People of Tennessee. Together, we will prevail! https://twitter.com/MariaLeeTN/status/1236052152398876672"
"425",425,3,0,3,FALSE,"2020-03-07 01:08:20+00:00","....I want to thank Acting Chief Mick Mulvaney for having served the Administration so well. He will become the United States Special Envoy for Northern Ireland. Thank you!"
"426",426,3,0,3,FALSE,"2020-03-07 01:08:19+00:00","I am pleased to announce that Congressman Mark Meadows will become White House Chief of Staff. I have long known and worked with Mark, and the relationship is a very good one...."
"427",427,2,0,2,FALSE,"2020-03-07 00:19:02+00:00","Congratulations to @FoxNews!"
"428",428,0,0,0,FALSE,"2020-03-06 21:21:27+00:00",""
"429",429,1,0,1,FALSE,"2020-03-06 21:18:54+00:00","Thank you @GovBillLee. We are a phone call away, and here for you!"
"430",430,1,0,1,FALSE,"2020-03-06 20:59:00+00:00","My Administration is with you all of the way, Tennessee. We love you!"
"431",431,0,1,-1,TRUE,"2020-03-06 15:47:58+00:00","Spoke to Governor @GavinNewsom early this morning about the cruise ship quarantined off the California Coast. CoronaVirus test kits have been delivered, testing is taking place now."
"432",432,3,2,1,TRUE,"2020-03-06 15:38:06+00:00","It is FAKE NEWS that @HHSGov @SecAzar is “sidelined” from the great job he is doing on the CoronaVirus Task Force. He has the total confidence of the @VP and myself, and is doing a fantastic job, as the numbers would indicate!"
"433",433,1,4,-3,FALSE,"2020-03-06 15:08:07+00:00","I will protect your Social Security and Medicare, just as I have for the past 3 years. Sleepy Joe Biden will destroy both in very short order, and he won’t even know he’s doing it!"
"434",434,0,0,0,FALSE,"2020-03-06 15:03:25+00:00"," https://twitter.com/SenateGOP/status/1235929951544672256"
"435",435,0,0,0,FALSE,"2020-03-06 14:21:18+00:00","JOBS, JOBS, JOBS!!!"
"436",436,1,0,1,FALSE,"2020-03-06 05:21:26+00:00","Thanks Linda, but they were really good last night!"
"437",437,1,0,1,FALSE,"2020-03-06 05:15:37+00:00","Thank you!"
"438",438,2,0,2,FALSE,"2020-03-06 03:49:40+00:00","My great honor!"
"439",439,1,0,1,FALSE,"2020-03-06 03:33:20+00:00","Thank you Audrey!"
"440",440,1,1,0,FALSE,"2020-03-06 03:27:23+00:00","The WALL is well under construction. So far we’re up to 129 miles, and by early next year we will have 500 miles completed!"
"441",441,4,0,4,TRUE,"2020-03-06 03:18:37+00:00","We have appointed 220 Federal Judges and two Supreme Court Justices. PROMISES MADE, PROMISES KEPT!"
"442",442,5,1,4,FALSE,"2020-03-06 03:15:23+00:00","Thank you David, a lifelong Democrat from Pennsylvania. We will continue MAKING AMERICA GREAT AGAIN and then, KEEP AMERICA GREAT!!!!"
"443",443,2,0,2,FALSE,"2020-03-06 02:05:17+00:00","Thank you Scranton, Pennsylvania. It was a great evening!"
"444",444,2,0,2,FALSE,"2020-03-06 01:59:14+00:00","Tonight’s Fox News Town Hall with @MarthaMacCallum and @BretBaier will rebroadcast at 11:00 P.M. Eastern on @FoxNews. Enjoy!"
"445",445,1,0,1,FALSE,"2020-03-05 20:38:22+00:00","Thank you Nan!"
"446",446,0,5,-5,TRUE,"2020-03-05 20:34:49+00:00","Gallup just gave us the highest rating ever for the way we are handling the CoronaVirus situation. The April 2009-10 Swine Flu, where nearly 13,000 people died in the U.S., was poorly handled. Ask MSDNC & lightweight Washington failure @RonaldKlain, who the President was then?"
"447",447,1,1,0,TRUE,"2020-03-05 19:02:39+00:00","The Department of Education is NOT closing hundreds of schools in rural areas of our Country. This is just more Fake News. We are investing greatly in our schools, and always will!"
"448",448,1,2,-1,FALSE,"2020-03-05 18:28:49+00:00","Mini Mike, you’re easy! https://twitter.com/MikeBloomberg/status/1235232463045177344"
"449",449,0,2,-2,TRUE,"2020-03-05 16:34:21+00:00","With approximately 100,000 CoronaVirus cases worldwide, and 3,280 deaths, the United States, because of quick action on closing our borders, has, as of now, only 129 cases (40 Americans brought in) and 11 deaths. We are working very hard to keep these numbers as low as possible!"
"450",450,2,3,-1,FALSE,"2020-03-05 16:22:04+00:00","“Joe Biden represents the past. President Trump represents the future.” @LisaMarieBoothe @edhenry @FoxNews"
"451",451,0,4,-4,FALSE,"2020-03-05 16:10:49+00:00","Elizabeth “Pocahontas” Warren, who was going nowhere except into Mini Mike’s head, just dropped out of the Democrat Primary...THREE DAYS TOO LATE. She cost Crazy Bernie, at least, Massachusetts, Minnesota and Texas. Probably cost him the nomination! Came in third in Mass."
"452",452,2,5,-3,FALSE,"2020-03-05 16:02:43+00:00",".@GOPLeader Kevin McCarthy informed me that I was 20 for 20 on Tuesday with respect to my Endorsement of candidates. Sadly, I didn’t get that information from the Fake News Media. They don’t report those things, or the far more than Dems cumulative votes, despite no opposition!"
"453",453,4,4,0,TRUE,"2020-03-05 15:53:33+00:00","“I want to commend the President for how he has handled the CoronaVirus situation, especially his early decision to shut down access into our Country from China, despite strong opposition to that decision.” @SenTomCotton Thank you Tom!"
"454",454,2,1,1,FALSE,"2020-03-05 15:30:50+00:00","Schumer has brought great danger to the steps of the United States Supreme Court!"
"455",455,3,5,-2,TRUE,"2020-03-05 14:30:50+00:00","I NEVER said people that are feeling sick should go to work. This is just more Fake News and disinformation put out by the Democrats, in particular MSDNC. Comcast covers the CoronaVirus situation horribly, only looking to do harm to the incredible & successful effort being made!"
"456",456,3,0,3,TRUE,"2020-03-05 14:11:25+00:00","As per recent Federal Court ruling, the Federal Government will be withholding funds from Sanctuary Cities. They should change their status and go non-Sanctuary. Do not protect criminals!"
"457",457,0,0,0,FALSE,"2020-03-05 04:16:20+00:00",""
"458",458,0,0,0,FALSE,"2020-03-05 04:03:48+00:00",""
"459",459,1,0,1,FALSE,"2020-03-05 02:03:37+00:00","I will be interviewed by @seanhannity on @FoxNews at 9:10 P.M."
"460",460,1,0,1,FALSE,"2020-03-05 01:23:29+00:00","Retired Four Star General Jack Keane will receive the PRESIDENTIAL MEDAL OF FREEDOM next week!"
"461",461,2,3,-1,FALSE,"2020-03-05 01:03:06+00:00","There can be few things worse in a civilized, law abiding nation, than a United States Senator openly, and for all to see and hear, threatening the Supreme Court or its Justices. This is what Chuck Schumer just did. He must pay a severe price for this!"
"462",462,2,2,0,FALSE,"2020-03-05 00:21:01+00:00","This is a direct & dangerous threat to the U.S. Supreme Court by Schumer. If a Republican did this, he or she would be arrested, or impeached. Serious action MUST be taken NOW!"
"463",463,3,0,3,FALSE,"2020-03-04 23:49:47+00:00","Thank you, keep up the great work!"
"464",464,4,2,2,TRUE,"2020-03-04 23:46:50+00:00","Congress has agreed to provide 8 Billion to fight Coronavirus! This means @CDCgov, @HHSGov, and @DHSgov will have the resources they need to Keep America Safe and keep the risk to workers and families very low. This is great news for our Health, our Economy, and our Nation!"
"465",465,2,0,2,FALSE,"2020-03-04 23:43:30+00:00","Will be interviewed by @SeanHannity tonight at 9:00 P.M. Eastern on @FoxNews. Enjoy!"
"466",466,0,5,-5,FALSE,"2020-03-04 20:06:11+00:00","Pandering Mini Mike Bloomberg, along with his wacky friend, Tom Steyer, have found out the hard way that you can’t buy the election! They both wish they had it to do over again!"
"467",467,8,1,7,FALSE,"2020-03-04 19:30:11+00:00","Today, it was my great honor to address the @LatinoCoalition Legislative Summit. With the hard work, love & devotion of millions of incredible Hispanic-Americans, our Country is thriving, our people are prospering, and our future has never looked brighter!"
"468",468,2,5,-3,FALSE,"2020-03-04 16:06:04+00:00","Mini Mike, “Three months ago I entered the race for President to defeat Donald Trump, (and I failed miserably!)."
"469",469,0,9,-9,FALSE,"2020-03-04 15:57:08+00:00","Mini Mike Bloomberg will now FIRE Tim O’Brien, and all of the fools and truly dumb people who got him into this MESS. This has been the worst, and most embarrassing, experience of his life...and now on to Sleepy Joe!"
"470",470,1,5,-4,FALSE,"2020-03-04 15:40:01+00:00","Mini Mike Bloomberg just “quit” the race for President. I could have told him long ago that he didn’t have what it takes, and he would have saved himself a billion dollars, the real cost. Now he will pour money into Sleepy Joe’s campaign, hoping to save face. It won’t work!"
"471",471,1,6,-5,TRUE,"2020-03-04 15:32:30+00:00","The Mayor of Los Angeles, @ericgarcetti, is dealing with us trying to get the Federal Government to fix the terrible problem he and the Dems have caused with the homeless, and the horrendous effects it is having on the City, which is a mess. I then watch him talk “trash” on me!"
"472",472,7,2,5,FALSE,"2020-03-04 15:21:44+00:00","Wow! If Elizabeth Warren wasn’t in the race, Bernie Sanders would have EASILY won Massachusetts, Minnesota and Texas, not to mention various other states. Our modern day Pocahontas won’t go down in history as a winner, but she may very well go down as the all time great SPOILER!"
"473",473,3,2,1,FALSE,"2020-03-04 14:56:01+00:00","The great people of Montana can have no better VOICE than Senator @SteveDaines. He is doing an incredible job! Whoever the Democrat nominee may be, please understand that I will be working hard with Steve all the way, & last night I was 20 for 20 (per @GOPLeader). WE NEED STEVE!"
"474",474,4,0,4,FALSE,"2020-03-04 14:20:44+00:00","I will be going to the Great State of Tennessee on Friday. The USA stands with the people of Tennessee 100%, whatever they need! The tornadoes were of record size & velocity. God bless your loved ones & all of the families affected! Thanks to @GovBillLee & @MarshaBlackburn"
"475",475,4,0,4,FALSE,"2020-03-04 12:48:23+00:00","MAKE AMERICA GREAT AGAIN and then, KEEP AMERICA GREAT!!!!"
"476",476,2,5,-3,FALSE,"2020-03-04 12:31:24+00:00","This is what happens to someone who loyally gets appointed Attorney General of the United States & then doesn’t have the wisdom or courage to stare down & end the phony Russia Witch Hunt. Recuses himself on FIRST DAY in office, and the Mueller Scam begins!"
"477",477,2,4,-2,FALSE,"2020-03-04 12:12:29+00:00","So selfish for Elizabeth Warren to stay in the race. She has Zero chance of even coming close to winning, but hurts Bernie badly. So much for their wonderful liberal friendship. Will he ever speak to her again? She cost him Massachusetts (and came in third), he shouldn’t!"
"478",478,3,10,-7,FALSE,"2020-03-04 11:52:25+00:00","The Democrat establishment came together and crushed Bernie Sanders, AGAIN! Even the fact that Elizabeth Warren stayed in the race was devastating to Bernie and allowed Sleepy Joe to unthinkably win Massachusetts. It was a perfect storm, with many good states remaining for Joe!"
"479",479,2,0,2,FALSE,"2020-03-04 05:59:06+00:00","THANK YOU CALIFORNIA! #KAG2020"
"480",480,2,0,2,FALSE,"2020-03-04 05:58:38+00:00","THANK YOU UTAH! #KAG2020"
"481",481,1,0,1,FALSE,"2020-03-04 03:39:34+00:00","But they really knew who was going to win!"
"482",482,3,4,-1,FALSE,"2020-03-04 03:35:16+00:00","Elizabeth “Pocahontas” Warren, other than Mini Mike, was the loser of the night. She didn’t even come close to winning her home state of Massachusetts. Well, now she can just sit back with her husband and have a nice cold beer!"
"483",483,1,9,-8,FALSE,"2020-03-04 03:23:58+00:00","The biggest loser tonight, by far, is Mini Mike Bloomberg. His “political” consultants took him for a ride. 700 million washed down the drain, and he got nothing for it but the nickname Mini Mike, and the complete destruction of his reputation. Way to go Mike!"
"484",484,2,0,2,FALSE,"2020-03-04 03:11:35+00:00","THANK YOU ARKANSAS! #KAG2020"
"485",485,2,0,2,FALSE,"2020-03-04 03:10:59+00:00","THANK YOU MINNESOTA! #KAG2020"
"486",486,2,0,2,FALSE,"2020-03-04 02:50:25+00:00","THANK YOU COLORADO! #KAG2020"
"487",487,2,0,2,FALSE,"2020-03-04 02:06:45+00:00","THANK YOU TEXAS! #KAG2020"
"488",488,2,0,2,FALSE,"2020-03-04 01:40:50+00:00","THANK YOU MAINE! #KAG2020"
"489",489,2,0,2,FALSE,"2020-03-04 01:30:01+00:00","THANK YOU TENNESSEE! #KAG2020"
"490",490,2,0,2,FALSE,"2020-03-04 01:28:58+00:00","THANK YOU MASSACHUSETTS! #KAG2020"
"491",491,2,0,2,FALSE,"2020-03-04 01:27:22+00:00","THANK YOU OKLAHOMA! #KAG2020"
"492",492,2,0,2,FALSE,"2020-03-04 01:26:57+00:00","THANK YOU ALABAMA! #KAG2020"
"493",493,2,0,2,FALSE,"2020-03-04 00:55:21+00:00","THANK YOU NORTH CAROLINA! #KAG2020"
"494",494,2,0,2,FALSE,"2020-03-04 00:54:49+00:00","THANK YOU VERMONT! #KAG2020"
"495",495,4,0,4,TRUE,"2020-03-03 23:18:04+00:00","The National Institutes of Health is home to some of the greatest doctors, scientists, and researchers in the world. Thank you for all your doing @NIH, keep up the great work! https://twitter.com/WhiteHouse/status/1234928714053369856"
"496",496,2,1,1,FALSE,"2020-03-03 21:10:46+00:00","I am calling on Congress to send me a Bill that fully and permanently funds the LWCF and restores our National Parks. When I sign it into law, it will be HISTORIC for our beautiful public lands. ALL thanks to @SenCoryGardner and @SteveDaines, two GREAT Conservative Leaders!"
"497",497,3,1,2,FALSE,"2020-03-03 18:30:37+00:00","I commend the hard work of Senator @SteveDaines and @SenCoryGardner in protecting funding for the Land and Water Conservation Fund for years to come. The citizens of Montana and Colorado thank you both!"
"498",498,0,0,0,FALSE,"2020-03-03 17:34:28+00:00","#PrayForNashville"
"499",499,6,0,6,FALSE,"2020-03-03 17:30:01+00:00","It was my great honor to address the National Association of Counties Legislative Conference where 1,200 County Leaders whose incredible devotion, talent, and drive directly and profoundly improve the lives of millions of Americans each and every day."
"500",500,6,0,6,TRUE,"2020-03-03 15:51:43+00:00","The Federal Reserve is cutting but must further ease and, most importantly, come into line with other countries/competitors. We are not playing on a level field. Not fair to USA. It is finally time for the Federal Reserve to LEAD. More easing and cutting!"
"501",501,1,2,-1,TRUE,"2020-03-03 14:49:00+00:00","Prayers for all of those affected by the devastating tornadoes in Tennessee. We will continue to monitor the developments. The Federal Government is with you all of the way during this difficult time."
"502",502,1,5,-4,FALSE,"2020-03-03 14:30:27+00:00","Mini Mike Bloomberg can never recover from his incompetent debate performances. Also, as mayor he was very bad under pressure - a choker!"
"503",503,3,0,3,FALSE,"2020-03-03 14:00:33+00:00","New book by @charliekirk11, already number 1, “The MAGA Doctrine”. Really great, SUPPORT CHARLIE KIRK. Buy now!"
"504",504,0,0,0,FALSE,"2020-03-03 13:30:21+00:00","Go Admiral Ronny!"
"505",505,0,7,-7,FALSE,"2020-03-03 13:24:48+00:00","Texas & Oklahoma: Mini Mike Bloomberg will kill your drilling, fracking and pipelines. Petroleum based “anything” is dead. Energy jobs gone. Don’t vote for Mini Mike!"
"506",506,5,3,2,TRUE,"2020-03-03 06:34:02+00:00","....paying higher rates than many others, when we should be paying less. Tough on our exporters and puts the USA at a competitive disadvantage. Must be the other way around. Should ease and cut rate big. Jerome Powell led Federal Reserve has called it wrong from day one. Sad!"
"507",507,3,1,2,TRUE,"2020-03-03 06:34:02+00:00","Australia’s Central Bank cut interest rates and stated it will most likely further ease in order to make up for China’s Coronavirus situation and slowdown. They reduced to 0.5%, a record low. Other countries are doing the same thing, if not more so. Our Federal Reserve has us...."
"508",508,5,0,5,FALSE,"2020-03-03 04:41:26+00:00","Thank you @JackBrewerBSI. We’re with you all the way. The American people know what’s going on, they totally get it. Watch what happens in November 2020! Thank you for your continued support. Together, we are going to KEEP AMERICA GREAT! #BlackVoicesforTrump"
"509",509,1,2,-1,FALSE,"2020-03-03 04:23:55+00:00","WOW! Sleepy Joe doesn’t know where he is, or what he’s doing. Honestly, I don’t think he even knows what office he's running for!"
"510",510,2,1,1,FALSE,"2020-03-03 04:17:15+00:00","The Democrats in the House should propose a very simple one year Payroll Tax cut. Great for the middle class, great for the USA!"
"511",511,0,0,0,FALSE,"2020-03-03 04:03:59+00:00",""
"512",512,8,1,7,FALSE,"2020-03-03 01:52:34+00:00","This is an incredible time for our nation—we are in the midst of the Great American Comeback! Jobs are booming, incomes are soaring, poverty is plummeting, confidence is surging, and we have completely rebuilt the awesome power of the U.S. Military. PROMISES MADE, PROMISES KEPT!"
"513",513,10,0,10,FALSE,"2020-03-03 01:34:50+00:00","I was thrilled to be back in the Great city of Charlotte, North Carolina with thousands of hardworking American Patriots who love our Country, cherish our values, respect our laws, and always put AMERICA FIRST! Thank you for a wonderful evening!! #KAG2020"
"514",514,0,0,0,FALSE,"2020-03-03 01:24:53+00:00",""
"515",515,3,0,3,FALSE,"2020-03-02 23:06:03+00:00","WOW! Thank you, just landed, see everyone soon! #KAG2020 "
"516",516,1,0,1,FALSE,"2020-03-02 21:47:49+00:00","Departing for the Great State of North Carolina!"
"517",517,0,1,-1,FALSE,"2020-03-02 21:32:54+00:00","They are staging a coup against Bernie!"
"518",518,1,0,1,FALSE,"2020-03-02 19:55:40+00:00","THANK YOU!"
"519",519,6,1,5,FALSE,"2020-03-02 19:55:07+00:00","Michelle @FischbachMN7 is running for Congress in Minnesota. Michelle will protect the unborn, is Strong on Crime & Borders, Cutting Taxes, your #2A, Loves our Military, Vets, & will stand w/ our Great Farmers. Michelle has my Complete & Total Endorsement!"
"520",520,6,1,5,FALSE,"2020-03-02 19:51:43+00:00","Congresswoman Kay @GrangerCampaign has worked hard for Texas and been a strong supporter of our #MAGA Agenda. She’s strong on #2A and Securing our Border and is 100% pro-life. Kay has my Complete and Total Endorsement!"
"521",521,6,0,6,FALSE,"2020-03-02 19:48:04+00:00","THANK YOU @BillCassidy for all of your support with our #MAGA Agenda. You are doing an outstanding job representing the people of Louisiana & the U.S.A. You have my Complete and Total Endorsement! #KAG2020"
"522",522,3,3,0,FALSE,"2020-03-02 17:01:23+00:00","The only people in favor of Mini Mike continuing with his hapless campaign are me and his political consultants, who are getting richer and richer by the day!"
"523",523,4,7,-3,FALSE,"2020-03-02 16:43:33+00:00",".@FoxNews is working hard pushing the Radical Left, Do Nothing Democrats. They want to be, unlike their competitors, @CNN & MSDNC (Comcast), Fair & Balanced. When will they ever learn. The Radical Left never even gave @FoxNews permission to partake in their low rated debates!"
"524",524,2,1,1,FALSE,"2020-03-02 15:16:34+00:00","....competitive disadvantage. We should be leading, not following!"
"525",525,2,2,0,TRUE,"2020-03-02 15:16:33+00:00","As usual, Jay Powell and the Federal Reserve are slow to act. Germany and others are pumping money into their economies. Other Central Banks are much more aggressive. The U.S. should have, for all of the right reasons, the lowest Rate. We don’t, putting us at a....."
"526",526,4,1,3,FALSE,"2020-03-02 14:19:23+00:00","Jack Welch, former Chairman and CEO of GE, a business legend, has died. There was no corporate leader like “neutron” Jack. He was my friend and supporter. We made wonderful deals together. He will never be forgotten. My warmest sympathies to his wonderful wife & family!"
"527",527,4,7,-3,FALSE,"2020-03-02 12:55:20+00:00","I was criticized by the Democrats when I closed the Country down to China many weeks ahead of what almost everyone recommended. Saved many lives. Dems were working the Impeachment Hoax. They didn’t have a clue! Now they are fear mongering. Be calm & vigilant!"
"528",528,3,4,-1,TRUE,"2020-03-02 12:42:49+00:00","“Ever since (Mini Mike) Bloomberg’s bad debate performances, his support has dropped.” @abcnews Dropped a lot. Only his highly paid consultants, who are laughing all the way to the bank, still support him...And by the way, he did not poll well as mayor in handling crisis!"
"529",529,3,0,3,FALSE,"2020-03-02 12:26:23+00:00","I am meeting with the major pharmaceutical companies today at the White House about progress on a vaccine and cure. Progress being made!"
"530",530,0,2,-2,FALSE,"2020-03-02 02:33:02+00:00","“The Democrat Party is a field of lightweights in complete disarray.” @kayleighmcenany @JudgeJeanine"
"531",531,3,0,3,FALSE,"2020-03-02 02:31:32+00:00","Gallup Poll numbers on the handling of this situation are outstanding, the best. Thank you!"
"532",532,6,0,6,FALSE,"2020-03-02 02:12:12+00:00","Watch Mark Levin interview of Charlie Kirk tonight at 11:00 P.M. on @FoxNews. Amazing!!! And, while you’re at it, go get Charlie’s new book, “The MAGA Doctrine: The Only Ideas That Will Win the Future”...This is a really GREAT book. Support Charlie Kirk!"
"533",533,2,1,1,FALSE,"2020-03-02 01:10:07+00:00","Sleepy Eyes Chuck Todd is not at the top of his game! Thank you."
"534",534,2,5,-3,FALSE,"2020-03-02 01:07:58+00:00","Sleepy Joe Biden also said that guns killed 150 million Americans last year, wants to win Georgia on Super Tuesday (not up), and got his speaking location wrong again!"
"535",535,1,0,1,FALSE,"2020-03-02 00:56:40+00:00","Thank you!"
"536",536,2,0,2,FALSE,"2020-03-02 00:54:07+00:00","Thank you. I love you too!"
"537",537,2,4,-2,FALSE,"2020-03-02 00:46:51+00:00","The Black community brilliantly turned their backs on Mini Mike because they know he is a pandering phony who never did right by them!"
"538",538,2,7,-5,FALSE,"2020-03-02 00:08:40+00:00","Mini Mike Bloomberg didn’t bring NYC back, as he said in his fake ad. It was @RudyGiuliani who brought NYC back and who also, with his endorsement, got Mini Mike elected (with barely a thank you). A boring mayor who the people couldn’t stand!"
"539",539,1,5,-4,FALSE,"2020-03-01 23:43:34+00:00","Pete Buttigieg is OUT. All of his SuperTuesday votes will go to Sleepy Joe Biden. Great timing. This is the REAL beginning of the Dems taking Bernie out of play - NO NOMINATION, AGAIN!"
"540",540,1,5,-4,FALSE,"2020-03-01 21:13:29+00:00","People are disgusted and embarrassed by the Fake News Media, as headed by the @nytimes, @washingtonpost, @comcast & MSDNC, @ABC, @CBSNews and more. They no longer believe what they see and read, and for good reason. Fake News is, indeed, THE ENEMY OF THE PEOPLE!"
"541",541,4,1,3,FALSE,"2020-03-01 21:00:52+00:00","“Who better than @RepRatcliffe, who got to the bottom of the FISAGATE & RUSSIAGATE HOAX. It makes a lot of sense to put John Ratcliffe in there (DNI).The Senate should quickly approve him. @DevinNunes @MariaBartiromo John will do a great job for the American people!"
"542",542,2,2,0,TRUE,"2020-03-01 20:17:46+00:00","A Poll in today’s New York Post says that 77% of “U.S. adults have confidence in their government’s ability to handle the Coronavirus (Number One), compared to other health threats.” 64% for Zika, 58% for Ebola. Others way down on list. Our professionals are doing a great job!"
"543",543,5,2,3,FALSE,"2020-03-01 15:11:11+00:00","The food is GREAT at Sammy’s Mexican Grill in Phoenix, Arizona. Congratulations to Betty & Jorge Rivas on doing such a wonderful job. I will try hard to stop by the next time I am in Phoenix. Support Sammy’s! @foxandfriends"
"544",544,2,2,0,TRUE,"2020-03-01 13:31:59+00:00","Coronavirus: In addition to screening travelers “prior to boarding” from certain designated high risk countries, or areas within those countries, they will also be screened when they arrive in America. Thank you! @VP @SecAzar @CDCgov @CDCDirector"
"545",545,1,2,-1,FALSE,"2020-03-01 13:23:38+00:00",".....a very dark and lonely path! Your reputation will never be the same!"
"546",546,3,5,-2,FALSE,"2020-03-01 13:23:34+00:00","Mini Mike Bloomberg’s consultants and so-called “advisors”(how did that advice work out? Don’t ask!), are on the “gravy train” and all making a fortune for themselves pushing Mini hard, when they knew he never had what it takes. Don’t pay them anymore Mike, they led you down...."
"547",547,0,6,-6,FALSE,"2020-03-01 05:39:39+00:00","I would find it hard to believe that failed presidential candidates Tom Steyer, or Mini Mike Bloombeg, would contribute to the Democrat Party, even against me, after the way they have been treated - laughed at & mocked. The real politicians ate them up and spit them out!"
"548",548,2,5,-3,FALSE,"2020-03-01 05:30:08+00:00","Tom Steyer who, other than Mini Mike Bloomberg, spent more dollars for NOTHING than any candidate in history, quit the race today proclaiming how thrilled he was to be a part of the the Democrat Clown Show. Go away Tom and save whatever little money you have left!"
"549",549,1,3,-2,FALSE,"2020-03-01 04:49:32+00:00","Congratulations to Sleepy Joe Biden!"
"550",550,1,6,-5,FALSE,"2020-03-01 04:45:36+00:00","Democrats are working hard to destroy the name and reputation of Crazy Bernie Sanders, and take the nomination away from him!"
"551",551,2,11,-9,FALSE,"2020-03-01 00:16:33+00:00","Sleepy Joe Biden’s victory in the South Carolina Democrat Primary should be the end of Mini Mike Bloomberg’s Joke of a campaign. After the worst debate performance in the history of presidential debates, Mini Mike now has Biden split up his very few voters, taking many away!"
"552",552,1,0,1,FALSE,"2020-02-29 23:42:15+00:00","THE BEST IS YET TO COME!"
"553",553,0,0,0,FALSE,"2020-02-29 23:10:24+00:00","Dana, you are the real deal!"
"554",554,1,0,1,FALSE,"2020-02-29 23:02:38+00:00","THANK YOU @CPAC! #CPAC2020"
"555",555,0,0,0,FALSE,"2020-02-29 23:00:54+00:00",""
"556",556,0,0,0,FALSE,"2020-02-29 22:58:19+00:00",""
"557",557,1,1,0,TRUE,"2020-02-29 17:02:35+00:00","I will be having a 1:30 P.M. Press Conference at the White House to discuss the latest CoronaVirus developments. Thank you!"
"558",558,1,0,1,FALSE,"2020-02-29 16:19:16+00:00","THANK YOU SOUTH CAROLINA!"
"559",559,0,0,0,FALSE,"2020-02-29 03:42:38+00:00",""
"560",560,0,0,0,FALSE,"2020-02-29 03:39:20+00:00",""
"561",561,2,0,2,FALSE,"2020-02-29 03:25:32+00:00","South Carolina was GREAT. A BIG & REALLY ENTHUSIASTIC CROWD!"
"562",562,0,6,-6,FALSE,"2020-02-29 03:00:18+00:00","A so-called reporter named @JohnJHarwood, who bombed so badly in the 2016 Presidential Debates that I thought he was going to be immediately fired (a Mini Mike type performance), is now with Fake News @CNN. A total loser!"
"563",563,6,1,5,FALSE,"2020-02-29 02:43:24+00:00","I hope we can get Admiral @RonnyJackson4TX of Texas, who served our Country so well, into the runoff election in #TX13! Ronny is strong on Crime and Borders, GREAT for our Military and Vets, and will protect your #2A. Get out and vote for Ronny on Tuesday, March 3rd!"
"564",564,3,0,3,FALSE,"2020-02-29 02:00:33+00:00","Thank you to all of the incredible Law Enforcement Officers in South Carolina tonight. We love you!"
"565",565,7,0,7,FALSE,"2020-02-29 01:58:27+00:00","It was my great honor to be back in South Carolina tonight, with thousands of hardworking American Patriots who believe in Faith, Family, God and Country. Thank you for a beautiful evening! #KAG2020"
"566",566,5,0,5,FALSE,"2020-02-28 22:24:23+00:00","I am pleased to announce the nomination of @RepRatcliffe (Congressman John Ratcliffe) to be Director of National Intelligence (DNI). Would have completed process earlier, but John wanted to wait until after IG Report was finished. John is an outstanding man of great talent!"
"567",567,2,0,2,FALSE,"2020-02-28 22:20:09+00:00","On my way to the Great State of South Carolina. See everyone soon! #MAGA #KAG"
"568",568,8,2,6,FALSE,"2020-02-28 21:01:05+00:00","Nobody fights harder for Montana than @SteveDaines. Steve is a close friend of mine, a STRONG Conservative, and a tremendous supporter of our #MAGA Agenda. He is strong on Crime & Borders, GREAT for our Military & Vets, & will protect your #2A. Steve has my Complete Endorsement!"
"569",569,1,4,-3,FALSE,"2020-02-28 20:28:00+00:00","The Dems are working hard to take the prized nomination away from Bernie. Back room politics, which Bernie is not very good at. His people will not let it happen again!"
"570",570,1,6,-5,FALSE,"2020-02-28 20:25:06+00:00","Mini Mike is getting slammed. His debates were, perhaps, the worst in presidential debating history. A total phony who disavowed “Stop & Frisk” after swearing by it for years, and even recently. He horribly overused it, & then dropped when running as a Dem. A total phony!"
"571",571,0,0,0,FALSE,"2020-02-28 20:03:18+00:00","We strongly stand with Terrence!"
"572",572,0,0,0,FALSE,"2020-02-28 19:31:19+00:00"," https://twitter.com/realDonaldTrump/status/1233403109038346246"
"573",573,3,0,3,FALSE,"2020-02-28 15:30:09+00:00","“You go around Pennsylvania and you see Trump signs everywhere. The Donald Trump situation is bigger than the Reagan Revolution. Donald Trump has inspired us.” @RjHarris15 WHP580"
"574",574,2,1,1,FALSE,"2020-02-28 15:24:01+00:00","Worst Polls, just like in 2016 when they were so far off the mark, are the @FoxNews Polls. Why doesn’t Fox finally get a competent Polling Company?"
"575",575,0,6,-6,FALSE,"2020-02-28 14:54:51+00:00","To the people of South Carolina, Tom Steyer is a joke, laughed at by everyone, a total incompetent. He made money in coal, now he “hates” coal. Did you see him fawning over Crazy Bernie? Has no chance, a loser for South Carolina, doesn’t deserve your vote!"
"576",576,3,0,3,FALSE,"2020-02-28 14:46:31+00:00","Will be in the Great State of South Carolina tonight, 7:00 P.M., for a really BIG Rally. Best place to be is a Trump Rally. See you later!"
"577",577,6,1,5,TRUE,"2020-02-28 06:13:04+00:00","“Federal Court Deals Major Blow To Sanctuary Cities.” @FoxNews In other words, there will be no more Federal Tax Dollars to States & Cities that will not cooperate with Federal Law Enforcement (ICE). This is BIG NEWS! Funds will be cut off immediately. MAKE AMERICA GREAT AGAIN!"
"578",578,1,7,-6,TRUE,"2020-02-28 05:43:14+00:00","The Do Nothing Democrats were busy wasting time on the Immigration Hoax, & anything else they could do to make the Republican Party look bad, while I was busy calling early BORDER & FLIGHT closings, putting us way ahead in our battle with Coronavirus. Dems called it VERY wrong!"
"579",579,2,6,-4,TRUE,"2020-02-28 05:05:02+00:00","So, the Coronavirus, which started in China and spread to various countries throughout the world, but very slowly in the U.S. because President Trump closed our border, and ended flights, VERY EARLY, is now being blamed, by the Do Nothing Democrats, to be the fault of “Trump”."
"580",580,1,0,1,FALSE,"2020-02-28 04:37:43+00:00","So nice!"
"581",581,4,7,-3,TRUE,"2020-02-28 03:41:19+00:00","“Diagnosis positive: @CNN is infected with Trump Derangement Syndrome. I’m calling out CNN for irresponsibly politicizing what should be a unifying battle against a virus that doesn’t choose sides.” @trish_regan @FoxNews Like I say, they are Fake News!"
"582",582,2,7,-5,FALSE,"2020-02-28 03:16:28+00:00","Word is that Mini Mike Bloomberg performed so poorly in the two debates, that he is thinking about dropping out of the Democrat Primary. The fact is, he was not true to himself, and the public was able to quickly figure him out. Not a good experience for Mini Mike!"
"583",583,5,4,1,TRUE,"2020-02-28 02:39:20+00:00","Congratulations and thank you to our great Vice President & all of the many professionals doing such a fine job at CDC & all other agencies on the Coronavirus situation. Only a very small number in U.S., & China numbers look to be going down. All countries working well together!"
"584",584,5,8,-3,TRUE,"2020-02-28 01:53:59+00:00","“Anti-Trump Network @CNN doing whatever it can to stoke a national Coronavirus panic. The far left Network pretty much ignoring anyone who they interview who doesn’t blame President Trump.” @trish_regan @FoxNews Media refuses to discuss the great job our professionals are doing!"
"585",585,0,0,0,FALSE,"2020-02-27 13:34:46+00:00","https://www.donaldjtrump.com/events/north-charleston-sc-feb-28-2020/"
"586",586,0,0,0,FALSE,"2020-02-27 06:02:56+00:00","They spied on my campaign!"
"587",587,10,1,9,FALSE,"2020-02-27 05:21:30+00:00",".@RepKevinBrady (R) of Texas-08 loves Texas & our Country. He has been a GREAT Congressman & supporter of #MAGA. Strong on Crime, Border, Military, Vets and your 2A, he is the best Tax Cutter in D.C. Kevin has my Complete & Total Endorsement. Vote on March 3rd. Thank you!"
"588",588,0,0,0,FALSE,"2020-02-27 01:51:36+00:00",""
"589",589,0,1,-1,FALSE,"2020-02-26 19:02:15+00:00","Nancy has allowed her District to go down more than any other in the USA! Hardly even recognizable."
"590",590,2,0,2,FALSE,"2020-02-26 16:20:43+00:00","My two great friends. Proud of you both!"
"591",591,0,0,0,FALSE,"2020-02-26 16:17:52+00:00","Eric, I can live with that!"
"592",592,1,0,1,FALSE,"2020-02-26 16:15:57+00:00","Piers, I like you too!"
"593",593,1,0,1,FALSE,"2020-02-26 13:51:13+00:00","Big Rally in the Great State of South Carolina on Friday. See you there!"
"594",594,2,1,1,FALSE,"2020-02-26 13:41:24+00:00","“Every poll you look at shows that Black support for President Trump is growing.” @RealCandaceO @MariaBartiromo"
"595",595,1,1,0,FALSE,"2020-02-26 13:35:32+00:00","Big Story, Big Win - Except in the Fake News, which won’t cover it!"
"596",596,0,7,-7,TRUE,"2020-02-26 13:24:23+00:00","....during a debate). Pocahontas was mean, & undisciplined, mostly aiming at Crazy Bernie and Mini Mike. They don’t know how to handle her, but I know she is a “chocker”. Steyer was a disaster who, along with Mini, are setting records in ’s per vote. Just give me an opponent!"
"597",597,2,10,-8,FALSE,"2020-02-26 13:24:17+00:00","Crazy, chaotic Democrat Debate last night. Fake News said Biden did well, even though he said half of our population was shot to death. Would be OVER for most. Mini Mike was weak and unsteady, but helped greatly by his many commercials (which are not supposed to be allowed...."
"598",598,1,0,1,FALSE,"2020-02-26 13:03:27+00:00","I will be having a News Conference at the White House, on this subject, today at 6:00 P.M. CDC representatives, and others, will be there. Thank you!"
"599",599,1,6,-5,FALSE,"2020-02-26 13:03:21+00:00","Low Ratings Fake News MSDNC (Comcast) & @CNN are doing everything possible to make the Caronavirus look as bad as possible, including panicking markets, if possible. Likewise their incompetent Do Nothing Democrat comrades are all talk, no action. USA in great shape! @CDCgov....."
"600",600,4,1,3,TRUE,"2020-02-26 11:39:45+00:00","Just landed. India was great, trip very successful. Heading to the White House. Meetings and calls scheduled today. @CDCgov, @SecAzar and all doing a great job with respect to Coronavirus! Briefing this afternoon."
"601",601,1,1,0,TRUE,"2020-02-26 07:19:49+00:00","“U.S. acted on the Coronavirus very, very quickly.” Gordon Chang @IngrahamAngle"
"602",602,1,0,1,FALSE,"2020-02-26 06:52:41+00:00","Thank you!"
"603",603,1,1,0,FALSE,"2020-02-26 06:49:12+00:00","Russia wants him to win!"
"604",604,0,1,-1,FALSE,"2020-02-26 06:47:58+00:00","An absolute disgrace!"
"605",605,3,0,3,FALSE,"2020-02-26 02:34:31+00:00","52% in the new Rasmussen Poll. 95% Approval Rating in the Republican Party. Thank you!"
"606",606,1,6,-5,TRUE,"2020-02-26 02:29:24+00:00","....Democrats talking point is that we are doing badly. If the virus disappeared tomorrow, they would say we did a really poor, and even incompetent, job. Not fair, but it is what it is. So far, by the way, we have not had one death. Let’s keep it that way!"
"607",607,3,2,1,TRUE,"2020-02-26 02:29:21+00:00","CDC and my Administration are doing a GREAT job of handling Coronavirus, including the very early closing of our borders to certain areas of the world. It was opposed by the Dems, “too soon”, but turned out to be the correct decision. No matter how well we do, however, the....."
"608",608,2,3,-1,TRUE,"2020-02-25 22:36:02+00:00","That is because they cover your favorite President relatively well. @CNN & MSDNC are dying in the ratings!"
"609",609,0,0,0,FALSE,"2020-02-25 22:00:07+00:00","No surprise!"
"610",610,0,0,0,FALSE,"2020-02-25 20:52:55+00:00","True, but we are getting it all done!"
"611",611,0,0,0,FALSE,"2020-02-25 20:43:33+00:00","A total miscarriage of justice!"
"612",612,1,4,-3,FALSE,"2020-02-25 20:01:29+00:00","There has rarely been a juror so tainted as the forewoman in the Roger Stone case. Look at her background. She never revealed her hatred of “Trump” and Stone. She was totally biased, as is the judge. Roger wasn’t even working on my campaign. Miscarriage of justice. Sad to watch!"
"613",613,2,3,-1,TRUE,"2020-02-25 14:02:15+00:00","Cryin’ Chuck Schumer is complaining, for publicity purposes only, that I should be asking for more money than 2.5 Billion to prepare for Coronavirus. If I asked for more he would say it is too much. He didn’t like my early travel closings. I was right. He is incompetent!"
"614",614,0,0,0,FALSE,"2020-02-25 12:58:49+00:00",""
"615",615,4,0,4,FALSE,"2020-02-25 04:09:20+00:00","....on all Trump, or Trump related, matters! While “elections have consequences”, I only ask for fairness, especially when it comes to decisions made by the United States Supreme Court!"
"616",616,3,5,-2,FALSE,"2020-02-25 04:09:20+00:00","“Sotomayor accuses GOP appointed Justices of being biased in favor of Trump.” @IngrahamAngle @FoxNews This is a terrible thing to say. Trying to “shame” some into voting her way? She never criticized Justice Ginsberg when she called me a “faker”. Both should recuse themselves.."
"617",617,4,10,-6,FALSE,"2020-02-25 02:29:59+00:00","..It has been a scam right from the beginning with the illegally started Mueller Report, FISA, the leaking, lying & more. Schiff should not have access to Intelligence, he is a corrupt pol. “Amazing that they went to Bernie Sanders, but not to President Trump.” @marthamaccallum"
"618",618,4,8,-4,FALSE,"2020-02-25 02:29:58+00:00","“U.S. Intelligence official overstated assessment of Russian efforts to help Trump.” @FoxNews @GreggJarrett They supposedly told Crazy Bernie that Russia was looking at him, not me. This is all a big scam between Intel and the Democrats. They want Bernie OUT, & hate “Trump”."
"619",619,0,0,0,FALSE,"2020-02-24 22:19:39+00:00","Spelled @GiannoCaldwell!"
"620",620,3,1,2,FALSE,"2020-02-24 22:08:51+00:00","Great new book just out, “Taken for Granted, How Conservatives Can Win Back Americans That Liberalism Failed”, by Gianni Caldwell, a young winner! He will be at the Ronald Reagan Library, Simi Valley, California, on Thursday at 6 PM, PT. Check it out!"
"621",621,1,0,1,FALSE,"2020-02-24 21:46:09+00:00","Totally correct!"
"622",622,2,2,0,TRUE,"2020-02-24 21:42:02+00:00","The Coronavirus is very much under control in the USA. We are in contact with everyone and all relevant countries. CDC & World Health have been working hard and very smart. Stock Market starting to look very good to me!"
"623",623,0,4,-4,FALSE,"2020-02-24 21:28:48+00:00","Set up by Schiff’s lies & leaks. Same with the Mueller Witch Hunt 3 years ago!"
"624",624,0,0,0,FALSE,"2020-02-24 18:13:56+00:00","https://twitter.com/narendramodi/status/1231918893964251136"
"625",625,1,0,1,FALSE,"2020-02-24 18:10:48+00:00","THANK YOU @NarendraModi! "
"626",626,1,0,1,FALSE,"2020-02-24 13:30:59+00:00","Thank you Lori, so true!"
"627",627,0,0,0,FALSE,"2020-02-24 12:46:11+00:00","मैं इसी लिए भारत आया हूँ, सद्भावना और प्रेम के साथ ताकि हम अपनी अभिलाषा प्रतीक अपनी सांझेदारी और अविश्वसनीय विस्तार सकें l"
"628",628,6,0,6,FALSE,"2020-02-24 11:09:57+00:00","Our two national constitutions both begin with the same three beautiful words: “We the people.” That means that in America and India alike, we honor, respect, trust, empower, and fight for the citizens we proudly serve! "
"629",629,0,0,0,FALSE,"2020-02-24 11:07:46+00:00","अमेरिका और भारत अपने देशों को मजबूत बनाएँगे, अपने लोगों को सम्पन्न बनाएँगे, बड़े सपने देखने वालों को और बड़ा बनाएँगे और अपना भविष्य पहले से कहीं अधिक उज्जवल बनाएँगे... और यह तो शुरुआत ही है।"
"630",630,0,0,0,FALSE,"2020-02-24 09:07:53+00:00","प्रथम महिला और मैं इस देश के हर नागरिक को एक सन्देश देने के लिए दुनिया का 8000 मील का चक्कर लगा कर यहां आये हैं l अमेरिका भारत को प्रेम करता है - अमेरिका भारत का सम्मान करता है - और अमरीका के लोग हमेशा भारत के लोगों के सच्चे और निष्ठावान दोस्त रहेंगे l"
"631",631,0,0,0,FALSE,"2020-02-24 04:43:45+00:00","हम भारत आने के लिए तत्पर हैं । हम रास्ते में हैँ, कुछ ही घंटों में हम सबसे मिलेंगे!"
"632",632,7,0,7,TRUE,"2020-02-23 23:07:43+00:00","95% Approval Rating in the Republican Party, a Record. 218 Federal Judges, also a Record. 2 Supreme Court Justices. Thank you!"
"633",633,0,0,0,FALSE,"2020-02-23 23:01:44+00:00",""
"634",634,3,5,-2,FALSE,"2020-02-23 22:51:07+00:00","Crazy Bernie and the Democrats should see this. I have done far more for the African American community than any President. Secured funding for HBCUs, Criminal Justice Reform, Opportunity Zones, School Choice, Record Low Unemployment, and so much more. THE BEST IS YET TO COME!"
"635",635,4,2,2,FALSE,"2020-02-23 21:19:28+00:00","Jeff Van Drew is a Courageous Leader that left the Do Nothing Democrats to better serve the Great people of New Jersey. HAPPY BIRTHDAY @CongressmanJVD!"
"636",636,1,12,-11,FALSE,"2020-02-23 18:45:26+00:00","Are any Democrat operatives, the DNC, or Crooked Hillary Clinton, blaming Russia, Russia, Russia for the Bernie Sanders win in Nevada. If so I suggest calling Bob Mueller & the 13 Angry Democrats to do a new Mueller Report, Democrat Edition. Bob will get to the bottom of it!"
"637",637,0,10,-10,FALSE,"2020-02-23 18:29:08+00:00","Somebody please tell incompetent (thanks for my high poll numbers) & corrupt politician Adam “Shifty” Schiff to stop leaking Classified information or, even worse, made up information, to the Fake News Media. Someday he will be caught, & that will be a very unpleasant experience!"
"638",638,1,0,1,FALSE,"2020-02-23 18:13:13+00:00","Look forward to being with all of my friends and supporters @CPAC on Saturday, February 29th! #KAG2020"
"639",639,0,0,0,FALSE,"2020-02-23 15:14:43+00:00","Departing for India with Melania!"
"640",640,0,3,-3,FALSE,"2020-02-23 01:55:18+00:00","Just another Shifty Schiff leak. Isn’t there a law about this stuff?"
"641",641,2,2,0,FALSE,"2020-02-23 00:17:24+00:00","“The Kremlin is reportedly backing Bernie Sanders bid to win the White House.” Jon Scott @FoxNews Why didn’t somebody tell me this?"
"642",642,5,8,-3,FALSE,"2020-02-22 23:55:36+00:00","Looks like Crazy Bernie is doing well in the Great State of Nevada. Biden & the rest look weak, & no way Mini Mike can restart his campaign after the worst debate performance in the history of Presidential Debates. Congratulations Bernie, & don’t let them take it away from you!"
"643",643,1,0,1,FALSE,"2020-02-22 22:30:10+00:00","Look so forward to being with my great friends in INDIA!"
"644",644,3,0,3,FALSE,"2020-02-22 22:21:12+00:00","Wow, great foresight!"
"645",645,0,0,0,FALSE,"2020-02-22 19:40:44+00:00",""
"646",646,5,10,-5,FALSE,"2020-02-22 15:18:17+00:00","Democrats in the Great State of Nevada (Which, because of the Economy, Jobs, the Military & Vets, I will win in November), be careful of Russia, Russia, Russia. According to Corrupt politician Adam “Shifty” Schiff, they are pushing for Crazy Bernie Sanders to win. Vote!"
"647",647,1,2,-1,FALSE,"2020-02-22 14:18:33+00:00","“An investigation into NOTHING.” The wonderful @trish_regan on the Mueller Witch Hunt!"
"648",648,2,0,2,FALSE,"2020-02-22 04:17:45+00:00","Incredible people, great Rally!"
"649",649,2,0,2,FALSE,"2020-02-22 03:58:38+00:00","Good luck Angela!"
"650",650,0,0,0,FALSE,"2020-02-22 03:54:17+00:00","Simply put, he choked!"
"651",651,0,9,-9,FALSE,"2020-02-22 03:43:56+00:00","....The reason for this is that the Do Nothing Democrats, using disinformation Hoax number 7, don’t want Bernie Sanders to get the Democrat Nomination, and they figure this would be very bad for his chances. It’s all rigged, again, against Crazy Bernie Sanders!"
"652",652,1,9,-8,FALSE,"2020-02-22 03:43:56+00:00","MSDNC (Comcast Slime), @CNN and others of the Fake Media, have now added Crazy Bernie to the list of Russian Sympathizers, along with @TulsiGabbard & Jill Stein (of the Green Party), both agents of Russia, they say. But now they report President Putin wants Bernie (or me) to win."
"653",653,7,0,7,FALSE,"2020-02-21 22:26:10+00:00","Republicans are fighting for citizens from every background, every community, & every walk of life. We are the party of boundless optimism, excitement, energy & enthusiasm. We are welcoming Americans of all parties & political persuasions to join our incredible movement to #MAGA!"
"654",654,7,2,5,FALSE,"2020-02-21 22:15:18+00:00","THANK YOU Las Vegas, Nevada! I was delighted to be back in a state I love, with proud, hardworking PATRIOTS. With your help, this November, we are going to defeat the Radical Socialist Democrats, and we are going to win Nevada in a landslide! #KAG2020"
"655",655,1,0,1,FALSE,"2020-02-21 19:23:31+00:00","ON MY WAY! #KAG2020 "
"656",656,2,4,-2,FALSE,"2020-02-21 17:34:10+00:00","So @TeamCavuto has very bad ratings on @foxnews with his Fake guests like A.B.Stoddard and others that still haven’t figured it all out. Will he get the same treatment as his friend Shepherd Smith, who also suffered from the ratings drought?"
"657",657,2,0,2,FALSE,"2020-02-21 16:19:00+00:00","@SenateGOP Highest Trump Poll Numbers EVER! Thank you!"
"658",658,3,0,3,FALSE,"2020-02-21 16:00:21+00:00","Mitch and I have made great progress. Coming back fast!"
"659",659,1,0,1,FALSE,"2020-02-21 15:51:39+00:00","Four great candidates are under consideration at DNI. Decision within next few weeks!"
"660",660,1,0,1,FALSE,"2020-02-21 15:47:26+00:00","Great!"
"661",661,1,5,-4,FALSE,"2020-02-21 15:36:48+00:00","Another misinformation campaign is being launched by Democrats in Congress saying that Russia prefers me to any of the Do Nothing Democrat candidates who still have been unable to, after two weeks, count their votes in Iowa. Hoax number 7!"
"662",662,1,1,0,TRUE,"2020-02-21 15:24:28+00:00","IF OUR FORMALLY TARGETED FARMERS NEED ADDITIONAL AID UNTIL SUCH TIME AS THE TRADE DEALS WITH CHINA, MEXICO, CANADA AND OTHERS FULLY KICK IN, THAT AID WILL BE PROVIDED BY THE FEDERAL GOVERNMENT, PAID FOR OUT OF THE MASSIVE TARIFF MONEY COMING INTO THE USA!"
"663",663,1,1,0,FALSE,"2020-02-21 06:20:02+00:00","“She should never have been on that jury. Everything about this stinks.” @JudgeJeanine @seanhannity @FoxNews"
"664",664,2,0,2,FALSE,"2020-02-21 06:16:27+00:00","Great Rally In Colorado. Thank you, will be back soon!"
"665",665,3,0,3,FALSE,"2020-02-21 03:51:19+00:00","Thank you to our great US Ambassador to Germany, @RichardGrenell, for stepping in to serve as acting DNI. I will be nominating a terrific candidate for the job very soon. Stay tuned!"
"666",666,5,3,2,FALSE,"2020-02-21 02:19:49+00:00","I was thrilled to be back in Colorado Springs tonight, beneath the majestic peaks of the Rocky Mountains, with thousands of terrific, hardworking American Patriots. With your help, this November, we are going to defeat the Radical Socialist Dems, and we are going to WIN Colorado!"
"667",667,2,0,2,FALSE,"2020-02-20 23:35:11+00:00","Wow, thank you — on my way!!"
"668",668,0,0,0,FALSE,"2020-02-20 23:32:22+00:00","Just arrived in Colorado, see everyone soon!"
"669",669,4,1,3,FALSE,"2020-02-20 21:53:28+00:00","Could somebody at @foxnews please explain to Trump hater A.B. Stoddard (zero talent!) and @TeamCavuto, that I won every one of my debates, from beginning to end. Check the polls taken immediately after the debates. The debates got me elected. Must be Fox Board Member Paul Ryan!"
"670",670,4,0,4,FALSE,"2020-02-20 21:10:09+00:00","It was my great honor to deliver the commencement address at the @LVMPD’s Hope for Prisoners Graduation Ceremony today, where we reaffirmed that America is a nation that believes in REDEMPTION!"
"671",671,2,3,-1,FALSE,"2020-02-20 18:24:04+00:00","“The real winner last night was Donald Trump.” Mini Mike Bloomberg. I agree!"
"672",672,1,2,-1,FALSE,"2020-02-20 18:18:01+00:00","“The decision not to prosecute Andy McCabe is utterly inexplicable.” @Judgenap @HARRISFAULKNER @FoxNews"
"673",673,3,7,-4,FALSE,"2020-02-20 17:13:42+00:00","“I don’t think there’s any chance whatsoever of Senator Sanders defeating President Trump.” Mini Mike Bloomberg. Mini, there’s even less chance, especially after watching your debate performance last night, of you winning the Democrat nomination...But I hope you do!"
"674",674,2,2,0,FALSE,"2020-02-20 15:29:18+00:00","John Kerry and Senator Chris Murphy grossly violated the Logan Act with respect to Iran. If a Republican did what they did, there would be very serious ramifications!"
"675",675,1,4,-3,FALSE,"2020-02-20 15:22:15+00:00","“They say Roger Stone lied to Congress.” @CNN OH, I see, but so did Comey (and he also leaked classified information, for which almost everyone, other than Crooked Hillary Clinton, goes to jail for a long time), and so did Andy McCabe, who also lied to the FBI! FAIRNESS?"
"676",676,1,0,1,FALSE,"2020-02-20 13:35:20+00:00","A really great moment!"
"677",677,2,3,-1,FALSE,"2020-02-20 13:27:52+00:00","This is the REAL Mini Mike. He admitted, many times, that he is “a fan of Donald Trump. He’s a New York ICON.” Thank you Mike!"
"678",678,0,2,-2,FALSE,"2020-02-20 12:37:26+00:00",".@JRubinBlogger (Jennifer Rubin), the wacko “conservative” of the @washingtonpost, must learn how to spell the name Bloomberg before it is too late & he is gone!"
"679",679,0,0,0,FALSE,"2020-02-20 06:52:00+00:00",""
"680",680,2,7,-5,FALSE,"2020-02-20 06:19:56+00:00","Mini Mike Bloomberg’s debate performance tonight was perhaps the worst in the history of debates, and there have been some really bad ones. He was stumbling, bumbling and grossly incompetent. If this doesn’t knock him out of the race, nothing will. Not so easy to do what I did!"
"681",681,6,0,6,FALSE,"2020-02-20 06:18:24+00:00","Thank you Arizona! With your help, your devotion, and your drive, we are going to keep on working, we are going to keep on fighting, and we are going to keep ON WINNING! America is thriving like never before, and the BEST IS YET TO COME!"
"682",682,2,0,2,FALSE,"2020-02-20 06:02:57+00:00","“What has happened to Roger Stone should never happen to anyone in our Country again.” @TuckerCarlson @FoxNews"
"683",683,0,0,0,FALSE,"2020-02-20 04:40:26+00:00",""
"684",684,1,5,-4,FALSE,"2020-02-20 04:32:58+00:00","The Democrat party is the party of high taxes, high crime, open borders, late-term abortion, socialism, blatant corruption, and the total destruction of your Second Amendment. The Republican Party is the party of the American Worker, the American Family, and the American Dream!"
"685",685,3,0,3,FALSE,"2020-02-20 04:14:24+00:00","A beautiful evening in Phoenix, Arizona with Great American Patriots. THANK YOU!"
"686",686,1,0,1,FALSE,"2020-02-20 01:28:42+00:00","Wow!"
"687",687,1,0,1,FALSE,"2020-02-20 00:25:48+00:00","....for the wonderful job he has done, and we look forward to working with him closely, perhaps in another capacity within the Administration!"
"688",688,7,1,6,FALSE,"2020-02-20 00:25:47+00:00","I am pleased to announce that our highly respected Ambassador to Germany, @RichardGrenell, will become the Acting Director of National Intelligence. Rick has represented our Country exceedingly well and I look forward to working with him. I would like to thank Joe Maguire...."
"689",689,0,0,0,FALSE,"2020-02-20 00:17:07+00:00","I AM ON MY WAY, SEE YOU SOON!"
"690",690,2,0,2,FALSE,"2020-02-19 23:58:28+00:00","Heading to Arizona, big rally and big crowd! #MAGA #KAG2020"
"691",691,2,1,1,FALSE,"2020-02-19 17:46:02+00:00","Rod Blagojevich did not sell the Senate seat. He served 8 years in prison, with many remaining. He paid a big price. Another Comey and gang deal! Thank you to @LisaMarieBoothe who really “gets” what’s going on! @FoxNews"
"692",692,3,5,-2,FALSE,"2020-02-19 17:10:06+00:00","Internal REAL Polls show I am beating all of the Dem candidates. The Fake News Polls (here we go again, just like 2016) show losing or tied. Their polls will be proven corrupt on November 3rd, just like the Fake News is corrupt!"
"693",693,4,0,4,FALSE,"2020-02-19 15:51:35+00:00","I would like to thank John Rood for his service to our Country, and wish him well in his future endeavors!"
"694",694,1,0,1,FALSE,"2020-02-19 15:42:44+00:00","Highest Stock Market In History, By Far!"
"695",695,2,6,-4,FALSE,"2020-02-19 14:54:43+00:00","Is corrupt Bloomberg News going to say what a pathetic debater Mini Mike is, that he doesn’t respect our great farmers, or that he has violated campaign finance laws at the highest and most sinister level with “payoffs” all over the place?"
"696",696,0,2,-2,FALSE,"2020-02-19 14:45:38+00:00","Kerry & Murphy illegally violated the Logan Act. This is why Iran is not making a deal. Must be dealt with strongly!"
"697",697,1,1,0,FALSE,"2020-02-19 14:23:56+00:00","There must be JUSTICE. This can never happen to a President, or our Country, again!"
"698",698,2,0,2,FALSE,"2020-02-19 00:13:03+00:00","Congratulations to Eddie DeBartolo Jr. and your wonderful family of friends!"
"699",699,3,6,-3,FALSE,"2020-02-18 22:37:14+00:00","...And this despite Fake Witch Hunts, the Mueller Scam, the Impeachment Hoax etc. With our Economy, Jobs, Military, Vets, 2A & more, I would be at 70%. Oh well, what can you do?"
"700",700,3,0,3,FALSE,"2020-02-18 22:37:07+00:00","THANK YOU! #MAGA #KAG2020"
"701",701,3,4,-1,TRUE,"2020-02-18 22:25:05+00:00","I hope the Federal Judges Association will discuss the tremendous FISA Court abuse that has taken place with respect to the Mueller Investigation Scam, including the forging of documents and knowingly using the fake and totally discredited Dossier before the Court. Thank you!"
"702",702,0,2,-2,FALSE,"2020-02-18 22:00:10+00:00","Mini Mike. No, I would rather run against you!"
"703",703,2,6,-4,FALSE,"2020-02-18 20:51:54+00:00",".....Mini is illegally buying the Democrat Nomination. They are taking it away from Bernie again. Mini Mike, Major Party Nominations are not for sale! Good luck in the debate tomorrow night and remember, no standing on boxes!"
"704",704,3,3,0,FALSE,"2020-02-18 20:51:53+00:00","What Mini Mike is doing is nothing less than a large scale illegal campaign contribution. He is “spreading” money all over the place, only to have recipients of his cash payments, many former opponents, happily joining or supporting his campaign. Isn’t that called a payoff? ....."
"705",705,8,0,8,FALSE,"2020-02-18 20:35:03+00:00","Chris Jacobs will be a great Congressman who will always fight for the people of New York. He supports our #MAGA Agenda, will continue to Secure Our Border, Loves our Military, Vets, and is Strong on the #2A. Chris has my Complete Endorsement for the Special Election on 4/28!"
"706",706,1,1,0,FALSE,"2020-02-18 20:20:34+00:00","The Mayor’s efforts to shield illegal aliens endangers the lives of the public and law enforcement who have to go into the field to apprehend those released. He shouldn’t be urging illegals to beat the system, he should be urging them to safely turn themselves in!"
"707",707,1,0,1,FALSE,"2020-02-18 15:31:34+00:00",".....would order a new trial, I’m not so sure about Judge Jackson, I don’t know.” @Judgenap (Andrew Napolitano) @foxandfriends"
"708",708,3,3,0,FALSE,"2020-02-18 15:31:34+00:00",".....existence of these tweets in which you were so harshly negative about the President & the people who support him. Don’t you think we wanted to know that before we put you on this jury.’ Pretty obvious he should (get a new trial). I think almost any judge in the Country....."
"709",709,1,1,0,FALSE,"2020-02-18 15:31:33+00:00","“Judge Jackson now has a request for a new trial based on the unambiguous & self outed bias of the foreperson of the jury, whose also a lawyer, by the way. ‘Madam foreperson, you’re a lawyer, you have a duty, an affirmative obligation, to reveal to us when we selected you the...."
"710",710,0,0,0,FALSE,"2020-02-18 15:29:43+00:00","....THE UNITED STATES IS OPEN FOR BUSINESS!"
"711",711,1,3,-2,FALSE,"2020-02-18 15:29:43+00:00","....I have seen some of the regulations being circulated, including those being contemplated by Congress, and they are ridiculous. I want to make it EASY to do business with the United States, not difficult. Everyone in my Administration is being so instructed, with no excuses..."
"712",712,1,3,-2,FALSE,"2020-02-18 15:29:43+00:00","....product and goods to China and other countries. That’s what trade is all about. We don’t want to make it impossible to do business with us. That will only mean that orders will go to someplace else. As an example, I want China to buy our jet engines, the best in the World...."
"713",713,1,2,-1,FALSE,"2020-02-18 15:29:42+00:00","The United States cannot, & will not, become such a difficult place to deal with in terms of foreign countries buying our product, including for the always used National Security excuse, that our companies will be forced to leave in order to remain competitive. We want to sell..."
"714",714,1,3,-2,FALSE,"2020-02-18 14:01:11+00:00","The Crooked DNC is working overtime to take the Democrat Nomination away from Bernie, AGAIN! Watch what happens to the Super Delegates in Round Two. A Rigged Convention!"
"715",715,0,1,-1,FALSE,"2020-02-18 13:14:22+00:00","....BUT MAYBE I STILL WILL. WITCH HUNT!"
"716",716,1,5,-4,FALSE,"2020-02-18 13:14:21+00:00","....badly tainted and, in my opinion, should be thrown out. Even Mueller’s statement to Congress that he did not see me to become the FBI Director (again), has been proven false. The whole deal was a total SCAM. If I wasn’t President, I’d be suing everyone all over the place..."
"717",717,0,7,-7,FALSE,"2020-02-18 13:14:20+00:00","These were Mueller prosecutors, and the whole Mueller investigation was illegally set up based on a phony and now fully discredited Fake Dossier, lying and forging documents to the FISA Court, and many other things. Everything having to do with this fraudulent investigation is..."
"718",718,1,0,1,FALSE,"2020-02-18 12:58:28+00:00",".....would order a new trial, I’m not so sure about Judge Jackson, I don’t know.” @Judgenap (Andrew Napolitano) @foxandfriends"
"719",719,3,3,0,FALSE,"2020-02-18 12:58:28+00:00",".....existence of these tweets in which you were so harshly negative about the President & the people who support him. Don’t you think we wanted to know that before we put you on this jury.’ Pretty obvious he should (get a new trial). I think almost any judge in the Country....."
"720",720,1,1,0,FALSE,"2020-02-18 12:58:27+00:00","“Judge Jackson now has a request for a new trial based on the unambiguous & self outed bias of the foreperson of the jury, whose also a lawyer, by the way. ‘Madam foreperson, your a lawyer, you have a duty, an affirmative obligation, to reveal to us when we selected you the....."
"721",721,1,0,1,FALSE,"2020-02-18 04:01:47+00:00","Thank you Clint!"
"722",722,2,0,2,FALSE,"2020-02-18 03:12:01+00:00","Praying for Ryan Newman, a great and brave @NASCAR driver! #PrayingForRyan"
"723",723,7,3,4,FALSE,"2020-02-17 23:40:30+00:00","....ever. Had to rebuild our military, which was totally depleted. Fed Rate UP, taxes and regulations WAY DOWN. If Dems won in 2016, the USA would be in big economic (Depression?) & military trouble right now. THE BEST IS YET TO COME. KEEP AMERICA GREAT!"
"724",724,6,2,4,FALSE,"2020-02-17 23:40:29+00:00","Did you hear the latest con job? President Obama is now trying to take credit for the Economic Boom taking place under the Trump Administration. He had the WEAKEST recovery since the Great Depression, despite Zero Fed Rate & MASSIVE quantitative easing. NOW, best jobs numbers...."
"725",725,0,0,0,FALSE,"2020-02-17 21:32:39+00:00",""
"726",726,1,0,1,FALSE,"2020-02-17 21:25:46+00:00","Completion of the Daytona 500 on Fox Network now. Enjoy!"
"727",727,2,5,-3,FALSE,"2020-02-17 15:13:28+00:00","“They tried to Impeach the President eight times before this last Impeachment trial that we went through. In Arizona, people are tired of their obstruction, their investigations, and their Impeachments. They want them to get to work.” @SenMcSallyAZ @foxandfriends Thanks Martha"
"728",728,1,0,1,FALSE,"2020-02-17 14:16:21+00:00","HAPPY PRESIDENT’S DAY!"
"729",729,0,0,0,FALSE,"2020-02-17 00:42:04+00:00","#DAYTONA500"
"730",730,2,4,-2,FALSE,"2020-02-16 17:11:48+00:00","Last week the Fake News said that a section of our powerful, under construction, Southern Border Wall “fell over”, trying to make it sound terrible, except the reason was that the concrete foundation was just poured & soaking wet when big winds kicked in. Quickly fixed “forever”."
"731",731,2,0,2,FALSE,"2020-02-16 15:25:00+00:00","Getting ready to go to the Daytona 500. Will be GREAT!"
"732",732,8,0,8,FALSE,"2020-02-15 22:40:44+00:00","Thank you to @JackBrewerBSI for your kind words on the great progress we have made on our powerful African-American Agenda. For one, lowest unemployment numbers in USA history. Many other great records! @foxandfriends @FoxNews"
"733",733,1,0,1,FALSE,"2020-02-15 22:36:03+00:00","BIG PROGRESS!"
"734",734,0,0,0,FALSE,"2020-02-15 22:35:26+00:00","Remember, will be at Daytona 500 tomorrow!"
"735",735,1,2,-1,FALSE,"2020-02-15 22:30:49+00:00","Years ago the Democrats had the money to build the Wall, but they didn’t have any idea how to get it done. I am building it bigger and better than ever thought possible!"
"736",736,1,0,1,FALSE,"2020-02-15 22:13:18+00:00","Thank you David!"
"737",737,3,5,-2,FALSE,"2020-02-15 14:39:43+00:00","IG report on Andrew McCabe: Misled Investigators over roll in news media disclosure...Lacked Candor (Lied) on four separate occasions...Authotized Media Leaks to advance personal interests...IG RECOMMENDED MCCABE’S FIRING. @FoxNews @IngrahamAngle"
"738",738,3,4,-1,FALSE,"2020-02-15 13:04:23+00:00",".....biggest test of his presidency emboldened, ready to claim exoneration, and take his case of grievance, persecution and resentment to the campaign trail.” Peter Baker @nytimes The Greatest Witch Hunt In American History!"
"739",739,3,5,-2,FALSE,"2020-02-15 13:04:20+00:00","“Ralph Waldo Emerson seemed to foresee the lesson of the Senate Impeachment Trial of President Trump. ‘When you strike at the King, Emerson famously said, “you must kill him.’ Mr. Trump’s foes struck at him but did not take him down. A triumphant Mr.Trump emerges from the....."
"740",740,4,0,4,FALSE,"2020-02-15 12:22:31+00:00","MAKE AMERICA GREAT AGAIN and then, KEEP AMERICA GREAT!"
"741",741,1,0,1,FALSE,"2020-02-14 23:57:33+00:00","Nice!"
"742",742,3,0,3,FALSE,"2020-02-14 23:38:35+00:00","Great honor, I think? Mark Zuckerberg recently stated that “Donald J. Trump is Number 1 on Facebook. Number 2 is Prime Minister Modi of India.” Actually, I am going to India in two weeks. Looking forward to it!"
"743",743,7,1,6,FALSE,"2020-02-14 22:44:23+00:00",".@LouieGohmertTX1 is a Fantastic Republican from the Great State of Texas! He fully supports our #MAGA and #KAG Agenda, Border WALL, Military, Vets, and your Second Amendment. Louie is my friend and has my Complete and Total Endorsement!"
"744",744,3,0,3,FALSE,"2020-02-14 22:40:55+00:00","I look forward to attending the Daytona 500 on Sunday with lots of my great friends from Florida, including the France family and @RepMichaelWaltz from #FL6. See you there, good luck to everyone! @NASCAR @SenRickScott @marcorubio @GovRonDeSantis"
"745",745,2,0,2,FALSE,"2020-02-14 22:31:12+00:00","Thank you Arnold, very nice."
"746",746,4,1,3,FALSE,"2020-02-14 22:30:05+00:00","....Today, @FLOTUS and I encourage all Americans to cherish and honor the memory of those we have lost through acts of love and service. We will hold Parkland forever in our hearts."
"747",747,2,3,-1,FALSE,"2020-02-14 22:30:05+00:00","It has been two years since the tragedy in Parkland. We will always mourn the innocent lives taken from us – 14 wonderful students and 3 terrific educators. Earlier this week, I met with families whose experiences from that horrible day still pierce the soul...."
"748",748,8,1,7,FALSE,"2020-02-14 22:16:22+00:00",".@TomMcClintock is a strong Conservative Leader who will always fight for the people of California. He fully supports our #MAGA Agenda, will continue to Secure Our Border, Loves our Military & Vets, & is Strong on the #2A. Tom has my Complete Endorsement!"
"749",749,9,1,8,FALSE,"2020-02-14 22:01:09+00:00",".@JodeyArrington from the Great State of Texas has been an incredible supporter of our #MAGA Agenda. Jodey fully supports Securing our Border w/ the WALL, he Loves our Military & Vets, and is Strong on the #2A. Jodey has my Complete and Total Endorsement!"
"750",750,8,1,7,FALSE,"2020-02-14 22:00:27+00:00",".@MoInTheHouse Brooks is running for Congress in the Great State of Alabama. He is a huge supporter of the #MAGA Agenda. Mo fully supports Securing our Border w/the WALL, he Loves our Military & Vets, & is Strong on the #2A. Mo has my Complete Endorsement! https://secure.winred.com/mobrooks/donate"
"751",751,5,1,4,FALSE,"2020-02-14 21:58:08+00:00","“The Greatest name in politics,” Patrick @McHenryCampaign from the Great State of North Carolina, is a Conservative Fighter and a true Leader who ALWAYS supports our #MAGA Agenda. Patrick has my Complete and Total Endorsement!"
"752",752,3,0,3,FALSE,"2020-02-14 20:41:01+00:00","Thank you to the beautiful country of Cambodia for accepting the @CarnivalCruise ship Westerdam into your port. The United States will remember your courtesy! @MickyArison"
"753",753,1,3,-2,FALSE,"2020-02-14 15:33:02+00:00","It is happening again to Crazy Bernie, just like last time, only far more obvious. They are taking the Democrat Nomination away from him, and there’s very little he can do. A Rigged System!"
"754",754,3,0,3,FALSE,"2020-02-14 15:26:37+00:00","95% Approval Rating in the Republican Party. Thank you!"
"755",755,3,4,-1,FALSE,"2020-02-14 15:25:18+00:00","....always continue. Every Republican Senator except Romney, many highly religious people, all very smart, voted against the Impeachment Hoax. @SenCapito was all in (a great person). I was told by many that Manchin was just a puppet for Schumer & Pelosi. That’s what he is!"
"756",756,1,6,-5,FALSE,"2020-02-14 15:25:17+00:00","I was very surprised & disappointed that Senator Joe Manchin of West Virginia voted against me on the Democrat’s totally partisan Impeachment Hoax. No President has done more for the great people of West Virginia than me (Pensions), and that will...."
"757",757,4,2,2,FALSE,"2020-02-14 15:20:28+00:00","“President Trump, with smart policies, has done more to help the Black community than any President in the modern era.” @IngrahamAngle @FoxNews"
"758",758,1,3,-2,FALSE,"2020-02-14 13:33:56+00:00","“The President has never asked me to do anything in a criminal case.” A.G. Barr This doesn’t mean that I do not have, as President, the legal right to do so, I do, but I have so far chosen not to!"
"759",759,1,2,-1,FALSE,"2020-02-13 18:30:30+00:00","I’m seeing Governor Cuomo today at The White House. He must understand that National Security far exceeds politics. New York must stop all of its unnecessary lawsuits & harrassment, start cleaning itself up, and lowering taxes. Build relationships, but don’t bring Fredo!"
"760",760,4,1,3,FALSE,"2020-02-13 16:04:35+00:00","....which he actually has a military and legal obligation to do. His incredible wife, Karen, who I have a lot of respect for, once pulled me aside & said strongly that “John respects you greatly. When we are no longer here, he will only speak well of you.” Wrong!"
"761",761,4,2,2,FALSE,"2020-02-13 16:04:34+00:00","When I terminated John Kelly, which I couldn’t do fast enough, he knew full well that he was way over his head. Being Chief of Staff just wasn’t for him. He came in with a bang, went out with a whimper, but like so many X’s, he misses the action & just can’t keep his mouth shut,."
"762",762,0,2,-2,FALSE,"2020-02-13 14:10:08+00:00","DRAIN THE SWAMP! We want bad people out of our government!"
"763",763,1,7,-6,FALSE,"2020-02-13 13:23:07+00:00","Mini Mike is a 5’4” mass of dead energy who does not want to be on the debate stage with these professional politicians. No boxes please. He hates Crazy Bernie and will, with enough money, possibly stop him. Bernie’s people will go nuts!"
"764",764,2,5,-3,FALSE,"2020-02-13 13:13:09+00:00","Mini Mike Bloomberg is a LOSER who has money but can’t debate and has zero presence, you will see. He reminds me of a tiny version of Jeb “Low Energy” Bush, but Jeb has more political skill and has treated the Black community much better than Mini!"
"765",765,1,1,0,FALSE,"2020-02-13 13:00:17+00:00","“Deven Nunes predicts that more examples of Mueller team misconduct will be revealed in coming weeks.” @seanhannity @FoxNews"
"766",766,5,1,4,FALSE,"2020-02-13 12:57:26+00:00","Now it looks like the fore person in the jury, in the Roger Stone case, had significant bias. Add that to everything else, and this is not looking good for the “Justice” Department. @foxandfriends @FoxNews"
"767",767,2,0,2,FALSE,"2020-02-12 22:18:58+00:00","GREAT NEWS! #KAG2020 "
"768",768,6,1,5,FALSE,"2020-02-12 21:33:13+00:00",".@ClaudiaTenney is a fantastic candidate running in New York, where she was a Great member of Congress. She is Strong on Crime, Borders, Cutting Taxes, your #2A, and she Loves our Military and Vets. Claudia has my Complete and Total Endorsement!"
"769",769,6,2,4,FALSE,"2020-02-12 21:29:03+00:00",".@NMalliotakis is running for Congress in NY, I know her well, we need her to defeat Max Rose, who voted for Impeachment! Nicole is Strong on Crime & Borders, #2A, Cutting Taxes, & she Loves our Military & Vets. Nicole has my Complete & Total Endorsement!"
"770",770,6,1,5,FALSE,"2020-02-12 21:25:14+00:00",".@MattForMontana Rosendale is a Strong & Conservative fighter for Montana. Matt stands w/ our Brave Veterans, Loves our Military, and he will continue working to Secure our Border. Matt will NEVER let our #2A go unprotected. Matt has my Total Endorsement!"
"771",771,6,1,5,FALSE,"2020-02-12 21:20:10+00:00",".@WesleyHuntTX is running for Congress in the Great State of Texas. He will help us accomplish our America First policies. Wesley is strong on Crime, the Border, our 2nd Amendment, Trade, Military and Vets. Wesley has my Complete and Total Endorsement!"
"772",772,6,0,6,FALSE,"2020-02-12 21:18:56+00:00",".@AugustPfluger is a Great Veteran and Strong Leader for Texas where he is running for Congress. He will protect your #2A, fight for our Farmers, Oil/Gas Workers, and he supports our #MAGA & #KAG Agenda. August has my Complete and Total Endorsement!"
"773",773,7,1,6,FALSE,"2020-02-12 21:18:16+00:00",".@BethVanDuyne did Great things as Mayor of Irving, Texas, with my Administration. She is a Strong Conservative who supports Border Security, Loves our Military, Vets, and supports your #2A. Beth has my Full Endorsement for Congress!"
"774",774,5,0,5,FALSE,"2020-02-12 21:14:09+00:00",".@JayObernolte of California is running for Congress in 2020. Jay will help me to continue securing the Southern Border, he Loves our GREAT Law Enforcement Officers, Military, Vets, and he will protect your #2A. Jay has my Complete and Total Endorsement!"
"775",775,3,0,3,TRUE,"2020-02-12 21:13:20+00:00","Ending surprise medical billing moving ahead in Congress! Thanks to Ways & Means and Education/Labor Committees for your work on Bills to protect patients and end medical bill ripoffs! Work with Energy & Commerce, HELP committees to send BIPARTISAN bill to my desk!"
"776",776,1,4,-3,FALSE,"2020-02-12 18:32:12+00:00","....If my hands were tied, Iran would have a field day. Sends a very bad signal. The Democrats are only doing this as an attempt to embarrass the Republican Party. Don’t let it happen!"
"777",777,3,5,-2,FALSE,"2020-02-12 18:32:11+00:00","It is very important for our Country’s SECURITY that the United States Senate not vote for the Iran War Powers Resolution. We are doing very well with Iran and this is not the time to show weakness. Americans overwhelmingly support our attack on terrorist Soleimani...."
"778",778,0,0,0,FALSE,"2020-02-12 15:09:49+00:00",""
"779",779,0,3,-3,FALSE,"2020-02-12 14:46:14+00:00",".@dagenmcdowell, “Every Democrat is running to raise taxes. She (Pocahontas) lied about her ethnicity, that was her problem.” @MariaBartiromo So true Dagen!"
"780",780,4,1,3,FALSE,"2020-02-12 12:06:23+00:00","Two months in jail for a Swamp Creature, yet 9 years recommended for Roger Stone (who was not even working for the Trump Campaign). Gee, that sounds very fair! Rogue prosecutors maybe? The Swamp! @foxandfriends @TuckerCarlson"
"781",781,2,6,-4,FALSE,"2020-02-12 11:53:00+00:00","Congratulations to Attorney General Bill Barr for taking charge of a case that was totally out of control and perhaps should not have even been brought. Evidence now clearly shows that the Mueller Scam was improperly brought & tainted. Even Bob Mueller lied to Congress!"
"782",782,2,5,-3,FALSE,"2020-02-12 11:35:54+00:00","Fake News @CNN and MSDNC have not surprisingly refused to talk about my record setting number of voters in New Hampshire (and in Iowa). That’s why they are poorly rated Fake News! I will win both states in November."
"783",783,3,6,-3,FALSE,"2020-02-12 04:45:44+00:00","The Fake News Media is looking hard for the Big Democrat Story, but there is nothing too fabulous. Wouldn’t a big story be that I got more New Hampshire Primary Votes than any incumbent president, in either party, in the history of that Great State? Not an insignificant fact!"
"784",784,1,0,1,FALSE,"2020-02-12 04:06:21+00:00","Thank you Brad!"
"785",785,0,0,0,FALSE,"2020-02-12 03:58:44+00:00","Prosecutorial Misconduct?"
"786",786,3,2,1,FALSE,"2020-02-12 03:23:07+00:00","Bootedgeedge (Buttigieg) is doing pretty well tonight. Giving Crazy Bernie a run for his money. Very interesting!"
"787",787,0,3,-3,FALSE,"2020-02-12 03:02:28+00:00","A very bad night for Mini Mike!"
"788",788,0,2,-2,FALSE,"2020-02-12 02:47:39+00:00","A lot of Democrat dropouts tonight, very low political I.Q."
"789",789,0,8,-8,FALSE,"2020-02-12 02:45:15+00:00","Who are the four prosecutors (Mueller people?) who cut and ran after being exposed for recommending a ridiculous 9 year prison sentence to a man that got caught up in an investigation that was illegal, the Mueller Scam, and shouldn’t ever even have started? 13 Angry Democrats?"
"790",790,2,1,1,FALSE,"2020-02-12 02:34:14+00:00","Impeachment King Steyer (how did that work out?) spent 200 Million Dollars and got less than 1% of the vote in Iowa, and only 3% of the Vote in New Hampshire. Could it be that something is just plain missing? Not easy to do what I did, is it?"
"791",791,2,2,0,FALSE,"2020-02-12 02:21:27+00:00","Elizabeth Warren, sometimes referred to as Pocahontas, is having a really bad night. I think she is sending signals that she wants out. Calling for unity is her way of getting there, going home, and having a “nice cold beer” with her husband!"
"792",792,0,1,-1,FALSE,"2020-02-12 02:09:26+00:00","Whatever happened to Hillary campaign manager Podesta’s BROTHER? Wasn’t he caught, forced to leave his firm, with BIG BAD things to happen? Why did nothing ever happen to him, only to the “other” side?"
"793",793,0,4,-4,FALSE,"2020-02-12 01:59:37+00:00","...And a swamp creature with “pull” was just sentenced to two months in jail for a similar thing that they want Stone to serve 9 years for. A phony Mueller Witch Hunt disgrace. Caught!"
"794",794,0,2,-2,FALSE,"2020-02-12 01:47:10+00:00","Is this the Judge that put Paul Manafort in SOLITARY CONFINEMENT, something that not even mobster Al Capone had to endure? How did she treat Crooked Hillary Clinton? Just asking!"
"795",795,1,2,-1,FALSE,"2020-02-12 01:40:33+00:00","All starting to unravel with the ridiculous 9 year sentence recommendation!"
"796",796,1,0,1,FALSE,"2020-02-11 16:39:59+00:00","When Jerome Powell started his testimony today, the Dow was up 125, & heading higher. As he spoke it drifted steadily downward, as usual, and is now at -15. Germany & other countries get paid to borrow money. We are more prime, but Fed Rate is too high, Dollar tough on exports."
"797",797,5,0,5,FALSE,"2020-02-11 15:49:53+00:00","New Stock Market RECORD. Congratulations, spend your money wisely. KEEP AMERICA GREAT!!!!!"
"798",798,3,0,3,FALSE,"2020-02-11 13:43:27+00:00","Great being in New Hampshire last night. I would say that was the biggest political Rally in New Hampshire history. Incredible evening!"
"799",799,3,0,3,FALSE,"2020-02-11 13:35:27+00:00","BEST USA ECONOMY IN HISTORY!"
"800",800,0,1,-1,FALSE,"2020-02-11 06:48:27+00:00","This is a horrible and very unfair situation. The real crimes were on the other side, as nothing happens to them. Cannot allow this miscarriage of justice!"
"801",801,0,1,-1,FALSE,"2020-02-11 06:32:05+00:00","Just returned to White House from Dover. Very sad!"
"802",802,2,1,1,FALSE,"2020-02-11 06:21:33+00:00","Nice conflict. Brown dropped out of presidential race FAST. Polled at ZERO!"
"803",803,0,1,-1,FALSE,"2020-02-11 05:57:24+00:00","Disgraceful!"
"804",804,0,1,-1,FALSE,"2020-02-11 05:55:04+00:00","Should never happen to another President!"
"805",805,2,0,2,FALSE,"2020-02-11 01:22:57+00:00","TOUGH GUYS FOR TRUMP!"
"806",806,1,0,1,FALSE,"2020-02-11 01:21:22+00:00","THANK YOU NEW HAMPSHIRE!"
"807",807,5,2,3,FALSE,"2020-02-10 20:24:24+00:00","“A lot of people feel defeated...Trump always wins. It seems like nothing can stop him.” Danny Villazon @nytimes @DanaPerino @FoxNews But isn’t that what you want from your President?"
"808",808,1,4,-3,FALSE,"2020-02-10 19:59:10+00:00","Wall Street Journal Editorial: “She (Crazy Nancy) aimed at Trump and hit Uncle Joe.”"
"809",809,2,1,1,FALSE,"2020-02-10 14:28:42+00:00","Meeting with U.S. Governors in a short while. All States are doing well. “Thank you Mr. President.”"
"810",810,9,2,7,FALSE,"2020-02-10 14:25:20+00:00","Thank you to @mirandadevine of the New York Post for your interesting (and correct) column today. “Trump has gained 20 points since Impeachment began in October. He gets 67% on economy. Nonwhite approval of Trump is also at a high: 28%, up 10 points in a year. Nice one, Nancy.”"
"811",811,0,1,-1,FALSE,"2020-02-10 13:14:45+00:00","Hope the Fake News, which never discusses it, is talking about the big crowds forming for my New Hampshire Rally tonight. They won’t!"
"812",812,4,8,-4,FALSE,"2020-02-10 12:37:42+00:00","Because of how badly they did with the Impeachment Hoax, AOC will primary Cryin’ Chuck Schumer, and win, and Jerry Nadler has a good chance of losing to his far left primary opponent! It is all getting quite interesting. Pelosi will lose the House, AGAIN! My poll numbers great."
"813",813,4,5,-1,FALSE,"2020-02-10 11:47:57+00:00","95% Approval Rating in the Republican Party, a Record! 53% overall (plus add 9 points?). Corrupt Democrat politicians have brought me to highest polling numbers ever with the Impeachment Hoax. Thank you Nancy!"
"814",814,0,4,-4,FALSE,"2020-02-10 11:28:32+00:00","Will be in Manchester, New Hampshire, tonight for a big Rally. Want to shake up the Dems a little bit - they have a really boring deal going on. Still waiting for the Iowa results, votes were fried. Big crowds in Manchester!"
"815",815,4,0,4,FALSE,"2020-02-09 19:56:18+00:00","MAKE AMERICA GREAT AGAIN and then, KEEP AMERICA GREAT!"
"816",816,0,1,-1,FALSE,"2020-02-09 19:54:48+00:00","DRAIN THE SWAMP!"
"817",817,1,5,-4,FALSE,"2020-02-09 19:52:34+00:00","....This is the biggest political crime in American History, by far. SIMPLY PUT, THE PARTY IN POWER ILLEGALLY SPIED ON MY CAMPAIGN, BOTH BEFORE AND AFTER THE ELECTION, IN ORDER TO CHANGE OR NULLIFY THE RESULTS OF THE ELECTION. IT CONTINUED ON WITH THE IMPEACHMENT HOAX. Terrible!"
"818",818,0,5,-5,FALSE,"2020-02-09 19:52:32+00:00","FBI Director Christopher Wray just admitted that the FISA Warrants and Survailence of my campaign were illegal. So was the Fake Dossier. THEREFORE, THE WHOLE SCAM INVESTIGATION, THE MUELLER REPORT AND EVERYTHING ELSE FOR THREE YEARS, WAS A FIXED HOAX. WHO PAYS THE PRICE?...."
"819",819,4,5,-1,FALSE,"2020-02-09 19:38:41+00:00","So good to see that Republicans will be winning the Great State of Alabama Senate Seat back, now that lightweight Senator @DougJones cast a partisan vote for the Impeachment Hoax. Thought his boss, Cryin’ Chuck, would have forced him to vote against the Hoax. A Do Nothing Stiff!"
"820",820,1,0,1,FALSE,"2020-02-09 19:20:03+00:00",".@LarrySabato is much better at giving you the answer after everything is finished and the final result is in, than he is at telling you what is going to happen because, in fact, he doesn’t have a clue!"
"821",821,5,1,4,FALSE,"2020-02-09 19:09:19+00:00","Sabato got it all wrong last time, never came close to understanding the Trump Voter. Actually it’s simple, MAKE AMERICA GREAT AGAIN and then, KEEP AMERICA GREAT!"
"822",822,1,0,1,FALSE,"2020-02-09 17:52:27+00:00","It’s all turning, and fast! MVP Heckler."
"823",823,1,2,-1,FALSE,"2020-02-09 17:48:21+00:00","“They (Conservatives) thought the merits of the Impeachment case were weak, and therefore his (Romney’s) judgement is questioned.” @MZHemingway @HowardKurtz @FoxNews"
"824",824,0,2,-2,FALSE,"2020-02-09 16:04:57+00:00","They are really mad at Senator Joe Munchkin in West Virginia. He couldn’t understand the Transcripts. Romney could, but didn’t want to!"
"825",825,2,4,-2,FALSE,"2020-02-09 15:58:52+00:00","Romney hurt some very good Republican Senators, and he was wrong about the Impeachment Hoax. No clue!"
"826",826,0,0,0,FALSE,"2020-02-09 15:51:20+00:00","Yes!!!!!"
"827",827,0,0,0,FALSE,"2020-02-09 15:43:24+00:00","This is so true!"
"828",828,0,0,0,FALSE,"2020-02-09 15:42:23+00:00","This will never get old!"
"829",829,1,1,0,FALSE,"2020-02-09 15:31:14+00:00","DeFace the Nation will tell @LindseyGrahamSC that he must start up Judiciary and not stop until the job is done. Clean up D.C. now, last chance!"
"830",830,4,4,0,FALSE,"2020-02-09 15:18:09+00:00","I grew up in New York City and, over many years, got to watch how GREAT NYC’s “Finest” are. Now, because of weak leadership at Governor & Mayor, stand away (water thrown at them) regulations, and lack of support, our wonderful NYC police are under assault. Stop this now!"
"831",831,1,3,-2,TRUE,"2020-02-09 14:40:00+00:00","The Dems are crazed, they will do anything. Honesty & truth don’t matter to them. They are badly wounded. Iowa vote count was a disaster for them!"
"832",832,1,2,-1,FALSE,"2020-02-09 14:34:25+00:00","Leading also in New Hampshire and most states. The Fake News hates to report this, but you will see on November 3rd."
"833",833,0,0,0,FALSE,"2020-02-09 04:20:36+00:00","The feeling of many about @MittRomney!"
"834",834,7,0,7,FALSE,"2020-02-09 01:56:59+00:00","Thank you to everyone for all of the great reviews I have gotten on my State of the Union Speech. It was an immense honor for me to have presented it to you and the citizens of our very strong and wonderful Country!"
"835",835,2,5,-3,FALSE,"2020-02-09 01:19:08+00:00","...But, just like the people of West Virginia will no longer look at weak & pathetic Joe Manchin the same (I got the Pension Bill approved, Manchin couldn’t do it), the wonderful people of Utah will never look at “grandstander” Mitt Romney with anything but contempt & disgust!"
"836",836,1,8,-7,FALSE,"2020-02-09 01:19:05+00:00","Can’t say I mind the fact that the great people of West Virginia are furious at their puppet Democrat Senator, Joe Manchin. They will never forget his phony vote on the Impeachment Hoax. All he had to do is read the Transcripts, sadly, which he wouldn’t understand anyway....."
"837",837,1,0,1,FALSE,"2020-02-09 00:55:20+00:00","Law Enforcement has been notified. Be careful tough guys who you play with!"
"838",838,2,2,0,FALSE,"2020-02-09 00:07:31+00:00","Great lineup on @FoxNews tonight with @JesseBWatters, @JudgeJeanine and & @greggutfeld. All starts at 8:00 P.M. Will be discussing and explaining the Impeachment Hoax!"
"839",839,3,0,3,FALSE,"2020-02-08 23:47:11+00:00","A great coach and a fantastic guy. His endorsement of me in Indiana was a very big deal!"
"840",840,2,0,2,FALSE,"2020-02-08 21:08:35+00:00","Pete Rose played Major League Baseball for 24 seasons, from 1963-1986, and had more hits, 4,256, than any other player (by a wide margin). He gambled, but only on his own team winning, and paid a decades long price. GET PETE ROSE INTO THE BASEBALL HALL OF FAME. It’s Time!"
"841",841,2,0,2,FALSE,"2020-02-08 19:48:10+00:00","Total and complete Endorsement for Debbie Lesko! @RepDLesko Love Arizona."
"842",842,1,3,-2,FALSE,"2020-02-08 19:40:14+00:00","Governor Cuomo wanted to see me this weekend. He just canceled. Very hard to work with New York - So stupid. All they do is sue me all the time!"
"843",843,2,2,0,FALSE,"2020-02-08 19:01:25+00:00","We will not be touching your Social Security or Medicare in Fiscal 2021 Budget. Only the Democrats will destroy them by destroying our Country’s greatest ever Economy!"
"844",844,2,10,-8,FALSE,"2020-02-08 18:43:16+00:00","...the worst weeks ever.” She could have had a much better week if Crazy Nancy, who is the most overrated person in politics (going to lose the House a second time), didn’t bring the phony & corrupt Impeachment Hoax. Dems can’t do anything right, just look at the Iowa vote count!"
"845",845,1,3,-2,FALSE,"2020-02-08 18:43:14+00:00",".@RepDebDingell, who called me, tears flowing, to thank me for rolling out the maximum “Red Carpet” for the funeral of her husband, then voted against me on the partisan Impeachmen Hoax, said “everybody (Dems) wants to get out of town. This has been, in my whole career, one of..."
"846",846,4,6,-2,FALSE,"2020-02-08 15:30:33+00:00","The only way to stop the crazed Radical Left, Do Nothing Democrats “is for the Republican Senate to run an offense here”. @LeeSmithDC @IngrahamAngle @FoxNews So true, although the Dems Hoaxes & Witch Hunts have driven up Republican Polls, and mine, mightily!"
"847",847,3,5,-2,FALSE,"2020-02-08 15:16:46+00:00","Crazy Nancy Pelosi’s Impeachment Hoax has lifted Republican Congressional Polls (she lost the House once before!), and my Polls, WAY UP, which was expected, but it has had a great effect on Republican Senate races, including North Carolina, Kentucky, Colorado and Arizona. Thanks!"
"848",848,2,2,0,FALSE,"2020-02-08 15:03:58+00:00","Thank you Iowa for the RECORD vote we just received in the Primary. The Dems were 25% down (although their votes are all fried!)."
"849",849,1,3,-2,FALSE,"2020-02-08 14:41:09+00:00","....was given a horrendous report by his superior, the man he reported to, who publicly stated that Vindman had problems with judgement, adhering to the chain of command and leaking information. In other words, “OUT”."
"850",850,2,4,-2,FALSE,"2020-02-08 14:41:09+00:00","Fake News @CNN & MSDNC keep talking about “Lt. Col.” Vindman as though I should think only how wonderful he was. Actually, I don’t know him, never spoke to him, or met him (I don’t believe!) but, he was very insubordinate, reported contents of my “perfect” calls incorrectly, &..."
"851",851,1,0,1,FALSE,"2020-02-08 12:23:26+00:00","Not good!"
"852",852,0,0,0,FALSE,"2020-02-08 03:09:12+00:00",""
"853",853,2,0,2,FALSE,"2020-02-07 23:26:59+00:00","After years building up other countries, we are finally rebuilding OUR Country. From our inner cities to our rural communities, the forgotten men and women of America are forgotten NO LONGER! #OpportunityNow"
"854",854,3,4,-1,FALSE,"2020-02-07 21:57:25+00:00","....always continue. Every Republican Senator except Romney, many highly religious people, all very smart, voted against the Impeachment Hoax. @SenCapito was all in (a great person). I was told by many that Manchin was just a puppet for Schumer & Pelosi. That’s all he is!"
"855",855,1,6,-5,FALSE,"2020-02-07 21:57:24+00:00","I was very surprised & disappointed that Senator Joe Manchin of West Virginia voted against me on the Democrat’s totally partisan Impeachment Hoax. No President has done more for the great people of West Virginia than me (Pensions), and that will...."
"856",856,3,0,3,FALSE,"2020-02-07 20:00:51+00:00","Great to be in Charlotte, North Carolina as we expand and grow this unprecedented economic momentum. Today, we launched a brand new nationwide campaign to revitalize under-served cities and towns across America – it’s called OPPORTUNITY NOW!"
"857",857,1,6,-5,FALSE,"2020-02-07 17:51:42+00:00","Another win just in. Nervous Nancy Pelosi and the Democrats in Congress sued me, thrown out. This one unanimous, in the D.C. Circuit. Witch Hunt!"
"858",858,0,0,0,FALSE,"2020-02-07 16:45:44+00:00","JOBS, JOBS, JOBS! #PromisesMadePromisesKept "
"859",859,1,1,0,FALSE,"2020-02-07 16:36:42+00:00","Iowa and New Hampshire will not be moved from the Primary Schedule as long as I am President. Great tradition!"
"860",860,0,0,0,FALSE,"2020-02-07 16:34:58+00:00","Off to North Carolina!"
"861",861,3,5,-2,FALSE,"2020-02-07 16:31:56+00:00","The Democrat Party has given up on counting votes in Iowa. Looks like it all got computer “fried”. Nobody knows who the real winner is. Maybe it’s Sleepy Joe, but it’s not looking that way. They lost millions & millions of dollars, all for NOTHING. But I WON Iowa big!"
"862",862,0,0,0,FALSE,"2020-02-07 13:51:07+00:00",""
"863",863,1,4,-3,FALSE,"2020-02-07 12:59:58+00:00","I think they should blame RUSSIA, RUSSIA, RUSSIA again! If they can’t count votes properly, how are they going to run U.S. HealthCare?"
"864",864,1,0,1,FALSE,"2020-02-07 12:55:06+00:00","Welcome back James!"
"865",865,2,0,2,FALSE,"2020-02-07 12:47:41+00:00","Very true, thank you Ted & John. I love Texas!"
"866",866,0,0,0,FALSE,"2020-02-07 12:39:38+00:00","So do I!"
"867",867,1,0,1,FALSE,"2020-02-07 12:00:48+00:00","Thank you Charlie!"
"868",868,0,1,-1,FALSE,"2020-02-07 11:28:13+00:00","Don’t worry, it won’t happen!"
"869",869,5,5,0,TRUE,"2020-02-07 10:31:23+00:00","....he will be successful, especially as the weather starts to warm & the virus hopefully becomes weaker, and then gone. Great discipline is taking place in China, as President Xi strongly leads what will be a very successful operation. We are working closely with China to help!"
"870",870,7,3,4,TRUE,"2020-02-07 10:31:22+00:00","Just had a long and very good conversation by phone with President Xi of China. He is strong, sharp and powerfully focused on leading the counterattack on the Coronavirus. He feels they are doing very well, even building hospitals in a matter of only days. Nothing is easy, but..."
"871",871,3,8,-5,FALSE,"2020-02-07 01:17:04+00:00","“The Senate acquitted President Trump of both charges fabricated by Congressional Democrats, led by Speaker Pelosi and Adam Schiff, to carry out the most egregious and partisan attack against any president in our history - a man they knew to be innocent.” @LouDobbs @FoxBusiness"
"872",872,1,2,-1,FALSE,"2020-02-07 01:16:08+00:00","“This President has done more for African Americans in this Country than any President since Lincoln.” @LouDobbs"
"873",873,0,0,0,FALSE,"2020-02-06 22:53:27+00:00",""
"874",874,7,1,6,FALSE,"2020-02-06 22:32:52+00:00","Welcome back to Earth, @Astro_Christina, and congratulations on breaking the female record for the longest stay in space! You’re inspiring young women and making the USA proud! Enjoyed speaking with you and @Astro_Jessica on the first all-female spacewalk IN HISTORY last year."
"875",875,3,1,2,FALSE,"2020-02-06 22:11:13+00:00","Nevada, I hear you on Yucca Mountain and my Administration will RESPECT you! Congress and previous Administrations have long failed to find lasting solutions – my Administration is committed to exploring innovative approaches – I’m confident we can get it done!"
"876",876,0,0,0,FALSE,"2020-02-06 21:13:35+00:00","So true!"
"877",877,0,0,0,FALSE,"2020-02-06 18:56:47+00:00",""
"878",878,2,2,0,FALSE,"2020-02-06 05:22:52+00:00","Had failed presidential candidate @MittRomney devoted the same energy and anger to defeating a faltering Barack Obama as he sanctimoniously does to me, he could have won the election. Read the Transcripts!"
"879",879,3,6,-3,FALSE,"2020-02-06 05:06:18+00:00","@nytimes “The Votes Were A Resounding Victory For Mr. Trump.” True, but the Impeachment Hoax was just a continuation of the Radical Left, Do Nothing Democrats corrupt practices!"
"880",880,0,0,0,FALSE,"2020-02-05 23:45:32+00:00",""
"881",881,1,2,-1,FALSE,"2020-02-05 22:07:04+00:00","I will be making a public statement tomorrow at 12:00pm from the @WhiteHouse to discuss our Country’s VICTORY on the Impeachment Hoax!"
"882",882,0,0,0,FALSE,"2020-02-05 21:49:49+00:00",""
"883",883,0,0,0,FALSE,"2020-02-05 20:44:31+00:00",""
"884",884,2,6,-4,TRUE,"2020-02-05 15:22:37+00:00","“The Democrats want to run a Country, and they can’t run a Caucus.” Brad Blakeman @FoxNews Iowa is a complete disaster for the Dems. They should bring in Mini Mike Bloomberg ASAP!"
"885",885,2,0,2,FALSE,"2020-02-05 13:19:14+00:00","Thank you Jonathan, and great job!"
"886",886,8,0,8,FALSE,"2020-02-05 12:59:35+00:00","It was a great and triumphant evening for our Country. Thank you for all of the nice remarks and wonderful reviews of my State of the Union Speech. It was my great honor to have done it!"
"887",887,0,0,0,FALSE,"2020-02-05 01:02:39+00:00","#SOTU2020"
"888",888,0,0,0,FALSE,"2020-02-04 23:52:14+00:00",""
"889",889,8,2,6,FALSE,"2020-02-04 15:59:56+00:00","My Approval Rating in the Republican Party = 95%, a record! Big Iowa win. Approval Rating overall = 53%, a new high. With our great Economy and other major successes, would be 20 points higher without the phony Witch Hunts and Hoaxes???"
"890",890,1,0,1,FALSE,"2020-02-04 15:52:17+00:00","Market up big today on very good economic news. JOBS, JOBS, JOBS!"
"891",891,5,3,2,FALSE,"2020-02-04 14:34:16+00:00","The Democrat Party in Iowa really messed up, but the Republican Party did not. I had the largest re-election vote in the history of that great state, by far, beating President Obama’s previous record by a lot. Also, 97% Plus of the vote! Thank you Iowa!"
"892",892,1,6,-5,TRUE,"2020-02-04 14:22:48+00:00","When will the Democrats start blaming RUSSIA, RUSSIA, RUSSIA, instead of their own incompetence for the voting disaster that just happened in the Great State of Iowa?"
"893",893,1,4,-3,FALSE,"2020-02-04 13:27:15+00:00","It is not the fault of Iowa, it is the Do Nothing Democrats fault. As long as I am President, Iowa will stay where it is. Important tradition!"
"894",894,5,2,3,TRUE,"2020-02-04 11:33:23+00:00","The Democrat Caucus is an unmitigated disaster. Nothing works, just like they ran the Country. Remember the 5 Billion Dollar Obamacare Website, that should have cost 2% of that. The only person that can claim a very big victory in Iowa last night is “Trump”."
"895",895,2,0,2,FALSE,"2020-02-04 04:27:51+00:00","Big WIN for us in Iowa tonight. Thank you!"
"896",896,7,0,7,FALSE,"2020-02-04 03:20:08+00:00","Many people do not know what a great guy & fantastic political talent the great Rush Limbaugh is. There is nobody like him. Looking for a speedy recovery for our friend!"
"897",897,0,0,0,FALSE,"2020-02-03 20:18:57+00:00",""
"898",898,0,3,-3,FALSE,"2020-02-03 17:03:03+00:00","Where’s the Whistleblower? Where’s the second Whistleblower? Where’s the Informer? Why did Corrupt politician Schiff MAKE UP my conversation with the Ukrainian President??? Why didn’t the House do its job? And sooo much more!"
"899",899,2,0,2,FALSE,"2020-02-03 16:52:48+00:00","KEEP AMERICA GREAT!"
"900",900,2,0,2,FALSE,"2020-02-03 16:52:16+00:00","MAKE AMERICA GREAT AGAIN!"
"901",901,3,1,2,FALSE,"2020-02-03 16:51:40+00:00","Republicans in Iowa, go out and Caucus today. Your great Trade Deals with China, Mexico, Canada, Japan, South Korea and more, are DONE. Great times are coming, after waiting for decades, for our Farmers, Ranchers, Manufacturers and ALL. Nobody else could have pulled this off!"
"902",902,2,8,-6,FALSE,"2020-02-03 16:42:38+00:00","I hope Republicans & the American people realize that the totally partisan Impeachment Hoax is exacty that, a Hoax. Read the Transcripts, listen to what the President & Foreign Minister of Ukraine said (“No Pressure”). Nothing will ever satisfy the Do Nothing, Radical Left Dems!"
"903",903,0,0,0,FALSE,"2020-02-03 13:15:36+00:00","@LindseyGrahamSC"
"904",904,2,2,0,FALSE,"2020-02-03 13:02:37+00:00","The DNC on Bernie Sanders, “Looks like they’re going to do it to him again, doesn’t it?” @SteveDoocy @foxandfriends"
"905",905,1,0,1,FALSE,"2020-02-03 05:25:22+00:00","Hope you liked this!"
"906",906,1,0,1,FALSE,"2020-02-03 05:08:56+00:00","Great company!"
"907",907,1,1,0,FALSE,"2020-02-03 05:05:00+00:00","Thank you Mike!"
"908",908,1,0,1,FALSE,"2020-02-03 03:41:58+00:00","So Great!"
"909",909,6,0,6,FALSE,"2020-02-03 03:27:02+00:00","Congratulations to the Kansas City Chiefs on a great game and a fantastic comeback under immense pressure. We are proud of you and the Great State of Missouri. You are true Champions!"
"910",910,7,0,7,FALSE,"2020-02-02 23:56:15+00:00","I promised to restore hope in America. That includes the least among us. Together, let’s KEEP AMERICA GREAT! Text TRUMP to 88022 if you liked our Super Bowl ad!"
"911",911,3,0,3,FALSE,"2020-02-02 23:13:16+00:00","ENJOY THE GAME USA, OUR COUNTRY IS DOING GREAT!"
"912",912,1,0,1,FALSE,"2020-02-02 20:17:03+00:00","My @SuperBowl Interview at 3:30 P.M. on @foxnetworks. Enjoy!"
"913",913,2,3,-1,FALSE,"2020-02-02 05:25:10+00:00","Mini Mike is now negotiating both to get on the Democrat Primary debate stage, and to have the right to stand on boxes, or a lift, during the debates. This is sometimes done, but really not fair!"
"914",914,0,7,-7,FALSE,"2020-02-02 05:17:07+00:00","Many of the ads you are watching were paid for by Mini Mike Bloomberg. He is going nowhere, just wasting his money, but he is getting the DNC to rig the election against Crazy Bernie, something they wouldn’t do for @CoryBooker and others. They are doing it to Bernie again, 2016."
"915",915,2,8,-6,FALSE,"2020-02-02 05:10:56+00:00","Mini Mike is part of the Fake News. They are all working together. In fact, Bloomberg isn’t covering himself (too boring to do), or other Dems. Only Trump. That sounds fair! It’s all the Fake News Media, and that’s why nobody believes in them any more."
"916",916,2,5,-3,FALSE,"2020-02-02 05:04:56+00:00","The Radical Left, Do Nothing Democrats, don’t want justice when pushing the Impeachment Hoax, they only want to destabilize the Republican Party so they can do better in the 2020 election, & that includes the House & Senate. They are playing with the people by taking it this far!"
"917",917,1,0,1,FALSE,"2020-02-02 04:48:56+00:00","Correct!"
"918",918,1,0,1,FALSE,"2020-02-02 04:42:09+00:00","Thanks for your invaluable help Chuck!"
"919",919,3,1,2,FALSE,"2020-02-02 04:28:55+00:00","Wall is moving along strong, tall and quickly. Thank you Jim for all of your help!"
"920",920,1,0,1,FALSE,"2020-02-02 04:25:03+00:00","Thank you John!"
"921",921,2,0,2,FALSE,"2020-02-02 04:24:16+00:00","Happy birthday to a wonderful man & friend!"
"922",922,0,0,0,FALSE,"2020-02-01 16:14:02+00:00","Getting a little exercise this morning!"
"923",923,4,3,1,FALSE,"2020-02-01 13:42:32+00:00","Trump poll numbers are the highest since election, despite constant phony Witch Hunts! Tens of thousands of people attending rallies (which the Fake News never mentions) to see “The Greatest Show On Earth”. Fun because USA is WINNING AGAIN!"
"924",924,4,2,2,FALSE,"2020-02-01 13:14:30+00:00","Congratulations to @loudobbs, Number One. Lou has shown the Fake News what happens when you cover “America’s Greatest President” fairly & objectively! #MAGA #KAG"
"925",925,1,1,0,FALSE,"2020-02-01 00:13:54+00:00","No matter what you give to the Democrats, in the end, they will NEVER be satisfied. In the House, they gave us NOTHING!"
"926",926,1,1,0,FALSE,"2020-01-31 23:05:44+00:00","Democrats = 17 Witnesses. Republicans = 0 Witnesses."
"927",927,3,5,-2,FALSE,"2020-01-31 21:06:48+00:00","The Radical Left, Do Nothing Democrats keep chanting “fairness”, when they put on the most unfair Witch Hunt in the history of the U.S. Congress. They had 17 Witnesses, we were allowed ZERO, and no lawyers. They didn’t do their job, had no case. The Dems are scamming America!"
"928",928,1,0,1,FALSE,"2020-01-31 14:33:25+00:00","Incredible numbers!"
"929",929,0,4,-4,FALSE,"2020-01-31 14:25:15+00:00","Nadler ripped final argument away from Schiff, thinks Shifty did a terrible job. They are fighting big time!"
"930",930,1,0,1,FALSE,"2020-01-31 04:22:00+00:00","THE BEST IS YET TO COME!"
"931",931,1,6,-5,FALSE,"2020-01-31 03:16:35+00:00","Americans across the political spectrum are disgusted by the Washington Democrats’ Partisan Hoaxes, Witch Hunts, & Con Jobs. Registered Democrats and Independents are leaving the Democrat Party in droves, & we are welcoming these voters to the Republican Party w/ wide open arms!"
"932",932,2,3,-1,FALSE,"2020-01-31 03:07:13+00:00","Washington Dems have spent the last 3 years trying to overturn the last election – and we will make sure they face another crushing defeat in the NEXT ELECTION. Together, we are going to win back the House, we are going to hold the Senate, & we are going to keep the White House!"
"933",933,6,2,4,TRUE,"2020-01-31 03:04:06+00:00","To keep America Safe, we have fully rebuilt the U.S. Military – it is now stronger, more powerful, and more lethal than ever before. Thanks to the courage of American Heroes, the ISIS Caliphate has been DESTROYED & its founder & leader – the animal known as al-Baghdadi – is DEAD!"
"934",934,4,2,2,FALSE,"2020-01-31 02:54:52+00:00","This November, we are going to defeat the Radical Socialist Democrats and win the Great State of Iowa in a Historic Landslide! #KAG2020"
"935",935,2,0,2,FALSE,"2020-01-31 02:48:06+00:00","Thank you Iowa, I love you!"
"936",936,2,0,2,FALSE,"2020-01-31 00:19:23+00:00","Great poll in Iowa, where I just landed for a Big Rally! #KAG2020 "
"937",937,2,3,-1,TRUE,"2020-01-30 22:04:35+00:00","Working closely with China and others on Coronavirus outbreak. Only 5 people in U.S., all in good recovery."
"938",938,1,0,1,FALSE,"2020-01-30 21:58:38+00:00","Leaving Michigan now, great visit, heading for Iowa. Big Rally!"
"939",939,0,2,-2,FALSE,"2020-01-30 20:37:01+00:00","BIGGEST TRADE DEAL EVER MADE, the USMCA, was signed yesterday and the Fake News Media barely mentioned it. They never thought it could be done. They have zero credibility!"
"940",940,1,0,1,FALSE,"2020-01-30 20:34:18+00:00","Just landed in Michigan. Car companies, and many others, are building and expanding here. Great to see!"
"941",941,3,0,3,FALSE,"2020-01-30 20:13:03+00:00","Happy birthday today to two of the very best in Congress—@RepMikeJohnson (age 48) and @RepLeeZeldin (age 40—big one!). Two Great American Patriots!!"
"942",942,8,3,5,FALSE,"2020-01-30 20:11:30+00:00","Congressman @MichaelCBurgess has done a Great job representing the people of Texas. He continues to protect your very important Second Amendment. Mike is Strong on Crime and the Border, he Loves our Great Vets and Military. Mike has my Complete and Total Endorsement!"
"943",943,8,0,8,FALSE,"2020-01-30 20:10:22+00:00","Congressman Brian @Babin4Congress of Texas has been a strong supporter of our #MAGA Agenda. He is strong on the Second Amendment and Securing our Border, he Loves our Great Vets and Military. Brian has my Complete and Total Endorsement!"
"944",944,0,0,0,FALSE,"2020-01-30 20:02:12+00:00",""
"945",945,0,0,0,FALSE,"2020-01-30 20:02:06+00:00",""
"946",946,0,0,0,FALSE,"2020-01-30 20:02:02+00:00",""
"947",947,0,0,0,FALSE,"2020-01-30 20:01:57+00:00",""
"948",948,1,1,0,FALSE,"2020-01-30 20:01:53+00:00","Great photos from a SOUTHERN BORDER WALL Briefing with Secretary of Defense, Mark @EsperDoD!"
"949",949,1,6,-5,FALSE,"2020-01-30 15:39:43+00:00","“Schiff blasted for not focusing on California homeless.” @foxandfriends His District is in terrible shape. He is a corrupt pol who only dreams of the Impeachment Hoax. In my opinion he is mentally deranged!"
"950",950,0,0,0,FALSE,"2020-01-30 03:27:19+00:00",""
"951",951,0,0,0,FALSE,"2020-01-30 00:32:52+00:00",""
"952",952,3,3,0,TRUE,"2020-01-30 00:06:52+00:00","Just received a briefing on the Coronavirus in China from all of our GREAT agencies, who are also working closely with China. We will continue to monitor the ongoing developments. We have the best experts anywhere in the world, and they are on top of it 24/7!"
"953",953,0,2,-2,FALSE,"2020-01-29 23:59:53+00:00","Nancy Pelosi wants Congress to take away authority Presidents use to stand up to other countries and defend AMERICANS. Stand with your Commander in Chiefs!"
"954",954,4,2,2,FALSE,"2020-01-29 23:59:24+00:00","With Votes in the House tomorrow, Democrats want to make it harder for Presidents to defend America, and stand up to, as an example, Iran. Protect our GREAT COUNTRY!"
"955",955,0,0,0,FALSE,"2020-01-29 23:00:42+00:00","GAME OVER!"
"956",956,0,0,0,FALSE,"2020-01-29 19:41:50+00:00",""
"957",957,4,1,3,FALSE,"2020-01-29 19:24:38+00:00","For the first time in American History, we have replaced a disastrous Trade Deal that REWARDED outsourcing with a truly FAIR and RECIPROCAL Trade Deal that will keep jobs, wealth and growth right here in AMERICA!"
"958",958,2,0,2,FALSE,"2020-01-29 19:21:50+00:00","Thanks to our pro-worker, pro-American economic policies, unemployment is at the lowest level in more than 50 years. We have created over 7 MILLION new JOBS. More Americans are working today than EVER before. We have the hottest ECONOMY on earth!"
"959",959,4,0,4,FALSE,"2020-01-29 18:38:39+00:00","USMCA is a cutting edge state of the art agreement that protects, defends and serves the great people of our Country. Promises Made, Promises Kept!"
"960",960,1,0,1,FALSE,"2020-01-29 18:36:26+00:00","USMCA is a massive win for American manufacturers and auto workers!"
"961",961,1,0,1,FALSE,"2020-01-29 15:49:25+00:00","They will never be satisfied!"
"962",962,2,0,2,FALSE,"2020-01-29 15:47:28+00:00","“The best evidence is the Transcript itself.” Brad Blakeman @FoxNews"
"963",963,1,4,-3,FALSE,"2020-01-29 15:39:04+00:00","There is much talk that certain Democrats are going to be voting with Republicans on the Impeachment Hoax, so that the Senate can get back to the business of taking care of the American people. Sorry, but Cryin’ Chuck Schumer will never let that happen!"
"964",964,1,1,0,FALSE,"2020-01-29 15:33:00+00:00","On the Iraq War Resolution being voted on tomorrow in the House of Represenatives, we are down to 5000 soldiers, and going down, and I want everyone, Republican and Democrat, to vote their HEART!"
"965",965,1,3,-2,FALSE,"2020-01-29 13:20:16+00:00","Mark Penn, Harris Poll: “It’s time to end the Impeachment Trial.” @foxandfriends Just another political Hoax by the Dems!"
"966",966,1,2,-1,FALSE,"2020-01-29 12:56:17+00:00","Remember Republicans, the Democrats already had 17 witnesses, we were given NONE! Witnesses are up to the House, not up to the Senate. Don’t let the Dems play you!"
"967",967,0,3,-3,FALSE,"2020-01-29 12:28:24+00:00","....many more mistakes of judgement, gets fired because frankly, if I listened to him, we would be in World War Six by now, and goes out and IMMEDIATELY writes a nasty & untrue book. All Classified National Security. Who would do this?"
"968",968,0,1,-1,FALSE,"2020-01-29 12:28:22+00:00","For a guy who couldn’t get approved for the Ambassador to the U.N. years ago, couldn’t get approved for anything since, “begged” me for a non Senate approved job, which I gave him despite many saying “Don’t do it, sir,” takes the job, mistakenly says “Libyan Model” on T.V., and.."
"969",969,0,3,-3,FALSE,"2020-01-29 11:51:53+00:00","Democrats admitting the Impeachment Hoax!"
"970",970,1,0,1,FALSE,"2020-01-29 11:41:24+00:00","Thank you!"
"971",971,0,2,-2,FALSE,"2020-01-29 05:07:05+00:00","Why didn’t John Bolton complain about this “nonsense” a long time ago, when he was very publicly terminated. He said, not that it matters, NOTHING!"
"972",972,3,4,-1,FALSE,"2020-01-29 02:25:15+00:00","No matter how many witnesses you give the Democrats, no matter how much information is given, like the quickly produced Transcripts, it will NEVER be enough for them. They will always scream UNFAIR. The Impeachment Hoax is just another political CON JOB!"
"973",973,4,2,2,FALSE,"2020-01-29 01:41:48+00:00","If you want your children to inherit the blessings that generations of Americans have fought and died to secure—then we must devote everything we have toward victory in 2020. Only this way, can we save the America we love – and drain the Washington Swamp once and for all!"
"974",974,2,4,-2,FALSE,"2020-01-29 01:37:45+00:00","Democrats are now the party of high taxes, high crime, open borders, late-term abortion, socialism, and blatant corruption. The Republican Party is the party of the American Worker, the American Family, and the American Dream! #TrumpRallyNJ #KAG2020"
"975",975,1,0,1,FALSE,"2020-01-29 01:32:53+00:00","Thank you Wildwood, New Jersey! #KeepAmericaGreat "
"976",976,3,4,-1,FALSE,"2020-01-28 22:23:26+00:00","It’s amazing what I’ve done, the most of any President in the first three years (by far), considering that for three years I’ve been under phony political investigations and the Impeachment Hoax! KEEP AMERICA GREAT!"
"977",977,0,0,0,FALSE,"2020-01-28 22:16:52+00:00","Heading to New Jersey. Big Rally, in fact, Really Big Rally!"
"978",978,0,0,0,FALSE,"2020-01-28 21:18:46+00:00","https://twitter.com/WhiteHouse/status/1222243101164625926"
"979",979,0,1,-1,FALSE,"2020-01-28 19:09:49+00:00","The Witch Hunt continues!"
"980",980,1,0,1,FALSE,"2020-01-28 18:26:49+00:00","This is what a future State of Palestine can look like, with a capital in parts of East Jerusalem."
"981",981,0,0,0,FALSE,"2020-01-28 18:26:48+00:00","هذا ما قد تبدو عليه دولة فلسطين المستقبلية بعاصمة في أجزاء من القدس الشرقية."
"982",982,3,0,3,FALSE,"2020-01-28 18:23:17+00:00","I will always stand with the State of Israel and the Jewish people. I strongly support their safety and security and their right to live within their historical homeland. It's time for peace!"
"983",983,0,0,0,FALSE,"2020-01-28 18:23:15+00:00","תמיד אעמוד לצד מדינת ישראל והעם היהודי. אני תומך בחוזקה בבטיחותם ובטחונם ובזכותם לחיות במולדתם ההיסטורית. הגיע הזמן לשלום!"
"984",984,0,0,0,FALSE,"2020-01-28 18:07:31+00:00",""
"985",985,2,1,1,FALSE,"2020-01-28 15:55:37+00:00","The Fed should get smart & lower the Rate to make our interest competitive with other Countries which pay much lower even though we are, by far, the high standard. We would then focus on paying off & refinancing debt! There is almost no inflation-this is the time (2 years late)!"
"986",986,1,0,1,FALSE,"2020-01-28 15:47:16+00:00","Are you better off now than you were three years ago? Almost everyone say YES!"
"987",987,3,5,-2,TRUE,"2020-01-28 15:44:57+00:00",".....So, what the hell has happened to @FoxNews. Only I know! Chris Wallace and others should be on Fake News CNN or MSDNC. How’s Shep Smith doing? Watch, this will be the beginning of the end for Fox, just like the other two which are dying in the ratings. Social Media is great!"
"988",988,3,5,-2,FALSE,"2020-01-28 15:44:56+00:00","Really pathetic how @FoxNews is trying to be so politically correct by loading the airwaves with Democrats like Chris Van Hollen, the no name Senator from Maryland. He has been on forever playing up the Impeachment Hoax. Dems wouldn’t even give Fox their low ratings debates...."
"989",989,0,2,-2,FALSE,"2020-01-28 05:26:57+00:00","Don Lemon, the dumbest man on television (with terrible ratings!)."
"990",990,1,0,1,FALSE,"2020-01-28 04:35:03+00:00","Charlie, I always knew you are brilliant!"
"991",991,2,0,2,FALSE,"2020-01-28 04:11:27+00:00","Thank you to Chuck & all. USMCA is going to be GREAT!"
"992",992,1,1,0,FALSE,"2020-01-28 04:09:29+00:00","Thank you Roger, it is a big Hoax!"
"993",993,0,0,0,FALSE,"2020-01-28 04:03:39+00:00","Congrats to Christine!"
"994",994,5,1,4,FALSE,"2020-01-28 04:01:33+00:00","A full & complete Endorsement for @RepDonBacon, who is doing a great job. Strong on crime, loves our Military, Vets & 2A!"
"995",995,0,0,0,FALSE,"2020-01-27 18:11:28+00:00",""
"996",996,0,0,0,FALSE,"2020-01-27 17:12:29+00:00",""
"997",997,1,1,0,FALSE,"2020-01-27 17:09:14+00:00","On International Holocaust Remembrance Day, we remember the millions of precious souls who perished as a result of the horrific crimes perpetrated by the Nazi regime...."
"998",998,0,2,-2,FALSE,"2020-01-27 15:12:09+00:00","Senate hearing on the Impeachment Hoax starts today at 1:00 P.M."
"999",999,1,4,-3,TRUE,"2020-01-27 14:56:21+00:00","We are in very close communication with China concerning the virus. Very few cases reported in USA, but strongly on watch. We have offered China and President Xi any help that is necessary. Our experts are extraordinary!"
"1000",1000,0,5,-5,FALSE,"2020-01-27 14:40:51+00:00","Schiff must release the IG report, without changes or tampering, which is said to be yet further exoneration of the Impeachment Hoax. He refuses to give it. Does it link him to Whistleblower? Why is he so adamant?"
"1001",1001,0,0,0,FALSE,"2020-01-27 13:42:28+00:00","READ THE TRANSCRIPTS!"
"1002",1002,0,1,-1,FALSE,"2020-01-27 11:57:42+00:00","The Democrat controlled House never even asked John Bolton to testify. It is up to them, not up to the Senate!"
"1003",1003,1,2,-1,FALSE,"2020-01-27 05:18:33+00:00","...(Democrats said I never met) and released the military aid to Ukraine without any conditions or investigations - and far ahead of schedule. I also allowed Ukraine to purchase Javelin anti-tank missiles. My Administration has done far more than the previous Administration."
"1004",1004,0,4,-4,FALSE,"2020-01-27 05:18:33+00:00","...transcripts of my calls with President Zelensky are all the proof that is needed, in addition to the fact that President Zelensky & the Foreign Minister of Ukraine said there was no pressure and no problems. Additionally, I met with President Zelensky at the United Nations..."
"1005",1005,0,2,-2,FALSE,"2020-01-27 05:18:33+00:00","I NEVER told John Bolton that the aid to Ukraine was tied to investigations into Democrats, including the Bidens. In fact, he never complained about this at the time of his very public termination. If John Bolton said this, it was only to sell a book. With that being said, the..."
"1006",1006,0,0,0,FALSE,"2020-01-27 03:47:14+00:00",""
"1007",1007,1,0,1,FALSE,"2020-01-26 23:54:34+00:00",".....Melania and I send our warmest condolences to Vanessa and the wonderful Bryant family. May God be with you all!"
"1008",1008,5,2,3,FALSE,"2020-01-26 23:54:34+00:00","Kobe Bryant, despite being one of the truly great basketball players of all time, was just getting started in life. He loved his family so much, and had such strong passion for the future. The loss of his beautiful daughter, Gianna, makes this moment even more devastating...."
"1009",1009,1,3,-2,FALSE,"2020-01-26 20:48:53+00:00","Reports are that basketball great Kobe Bryant and three others have been killed in a helicopter crash in California. That is terrible news!"
"1010",1010,0,1,-1,FALSE,"2020-01-26 20:39:07+00:00","Nothing done wrong, READ THE TRANSCRIPTS!"
"1011",1011,2,0,2,FALSE,"2020-01-26 20:01:06+00:00","Majority of people say “the U.S. Senate already has enough information!” @FoxNews"
"1012",1012,13,0,13,TRUE,"2020-01-26 16:24:41+00:00","95% Approval Rating in the Republican Party. Thank you! 191 Federal Judges (a record), and two Supreme Court Justices, approved. Best Economy & Employment Numbers EVER. Thank you to our great New, Smart and Nimble REPUBLICAN PARTY. Join now, it’s where people want to be!"
"1013",1013,0,6,-6,FALSE,"2020-01-26 16:07:35+00:00","Sleepyeyes Chuck Todd of Meet the Corrupt Press, just had a “totally” softball interview with conman Adam Schiff, never even calling Shifty out on his fraudulent statement to Congress, where he made up ALL of the words of my conversation with the Ukrainian President! FAKE NEWS"
"1014",1014,0,3,-3,FALSE,"2020-01-26 15:27:21+00:00","After having been exposed as a fraud and corrupt, can anyone, including Sleepyeyes Chuck Todd of Fake @NBCNews, continue to listen to his con?"
"1015",1015,0,0,0,FALSE,"2020-01-26 15:06:45+00:00","“Again: Read the Transcript!” Michael Goodwin, New York Post, Sunday."
"1016",1016,1,7,-6,FALSE,"2020-01-26 14:45:02+00:00","Great Editorial in today’s Wall Street Journal, “And Congress Shall Be King.” Bottom line: “The President becomes a vassal of King Congress. This is another reason for the Senate to repudiate this House Impeachment as its own abuse of power.” A partisan Hoax!"
"1017",1017,0,1,-1,FALSE,"2020-01-26 14:24:30+00:00","Why didn’t Schiff release this?"
"1018",1018,1,0,1,FALSE,"2020-01-26 14:16:25+00:00","A very good question!"
"1019",1019,1,6,-5,FALSE,"2020-01-26 14:03:26+00:00","“This is what Democrats have done. They want to create the idea that there is all this smoke so people think there’s fire. They did this with Russia Collusion, & there was no fire. It makes zero sense what the Democrats are accusing him of.” @LisaMarieBoothe @foxandfriends"
"1020",1020,2,0,2,FALSE,"2020-01-26 13:55:06+00:00","“It was amazing to watch three days of arguments dismantled in two hours.” @PeteHegseth @foxandfriends"
"1021",1021,0,1,-1,FALSE,"2020-01-26 13:36:05+00:00","Paul Krugman is a lightweight thinker who doesn’t have a clue. Caused huge economic damage to his follower’s pocketbooks. He, and others, should be fired by @nytimes!"
"1022",1022,1,1,0,FALSE,"2020-01-26 13:24:03+00:00","Rep. Jim Jordan Delivers Knockout Blow to Schiff’s Reputation"
"1023",1023,1,4,-3,FALSE,"2020-01-26 13:20:53+00:00","Shifty Adam Schiff is a CORRUPT POLITICIAN, and probably a very sick man. He has not paid the price, yet, for what he has done to our Country!"
"1024",1024,1,9,-8,FALSE,"2020-01-26 13:09:34+00:00","The Impeachment Hoax is a massive election interference the likes of which has never been seen before. In just two hours the Radical Left, Do Nothing Democrats have seen their phony case absolutely shredded. Shifty is now exposed for illegally making up my phone call, & more!"
"1025",1025,0,0,0,FALSE,"2020-01-26 04:07:21+00:00","True!"
"1026",1026,0,0,0,FALSE,"2020-01-26 03:10:49+00:00",""
"1027",1027,0,1,-1,FALSE,"2020-01-26 02:15:14+00:00","All Democrats should watch this!"
"1028",1028,1,0,1,FALSE,"2020-01-26 01:43:48+00:00","وزیر امور خارجه ایران می گوید ایران خواستار مذاکره با ایالات متحده است اما می خواهد که تحریم ها برداشته شود. @FoxNews @OANN نه، مرسی!"
"1029",1029,1,1,0,FALSE,"2020-01-26 00:16:02+00:00","Iranian Foreign Minister says Iran wants to negotiate with The United States, but wants sanctions removed. @FoxNews @OANN No Thanks!"
"1030",1030,2,0,2,FALSE,"2020-01-25 22:05:57+00:00","Previous quote from the great Republican Senator, Jim Inhofe, of Oklahoma - Chairman of the Senate Armed Services Committee"
"1031",1031,1,0,1,FALSE,"2020-01-25 21:57:38+00:00","....at the judges that we have right now."
"1032",1032,3,1,2,FALSE,"2020-01-25 21:57:34+00:00","“You don’t come to court and ask for witnesses after you’ve already presented your case, unless you know your case is not working. I think their real motivation is for them to keep this President busy. We’re doing a great job on the economy, we’re building our military, look....."
"1033",1033,1,1,0,FALSE,"2020-01-25 20:46:41+00:00","Martha is a great leader on this issue!"
"1034",1034,1,0,1,FALSE,"2020-01-25 20:37:23+00:00","Three great men!"
"1035",1035,1,0,1,FALSE,"2020-01-25 20:11:45+00:00","Such a great family!"
"1036",1036,1,0,1,FALSE,"2020-01-25 19:44:30+00:00","Thank you Nick!"
"1037",1037,1,5,-4,FALSE,"2020-01-25 18:41:03+00:00","Any fair minded person watching the Senate trial today would be able to see how unfairly I have been treated and that this is indeed the totally partisan Impeachment Hoax that EVERYBODY, including the Democrats, truly knows it is. This should never be allowed to happen again!"
"1038",1038,1,12,-11,FALSE,"2020-01-25 14:37:54+00:00","Our case against lyin’, cheatin’, liddle’ Adam “Shifty” Schiff, Cryin’ Chuck Schumer, Nervous Nancy Pelosi, their leader, dumb as a rock AOC, & the entire Radical Left, Do Nothing Democrat Party, starts today at 10:00 A.M. on @FoxNews, @OANN or Fake News @CNN or Fake News MSDNC!"
"1039",1039,4,0,4,FALSE,"2020-01-25 14:19:35+00:00","....secondly, he is fulfilling every promise he made, and that is making his opponents apoplectic. They’re trying to get him out of office, and they’re not going to succeed.” Pastor Robert Jeffress, author of “Choosing the Extraordinary Life” Thank you Pastor! @LouDobbs @FoxBus"
"1040",1040,3,4,-1,FALSE,"2020-01-25 14:19:35+00:00","“I like President Trump’s Tweets (Social Media), I like everything about him...and this Ukraine stuff, the trial, the impeachment, this isn’t t about Ukraine. Donald Trump has committed the two unpardonable sins in the eyes of the Democrats. He beat Hillary Clinton in 2016, and.."
"1041",1041,1,3,-2,FALSE,"2020-01-25 13:59:34+00:00","....intimidated by this national left wing media, that reduces most politicians and most public figures to whining, crying, puddles of cowardice - it is really something to have a man in the White House who has a courageous heart and does what he says he will do.”"
"1042",1042,3,2,1,FALSE,"2020-01-25 13:59:34+00:00","The Great @LouDobbs: “People know, after 3 years of this President, the most historic President in our Country’s history, that there is no one who can touch what he’s done in 3 years, foreign policy, domestic policy, you name it, it’s amazing. Just to have the guts not to be....."
"1043",1043,7,0,7,TRUE,"2020-01-25 00:35:31+00:00","It was my honor to welcome our nation’s Mayors to the @WhiteHouse as we continue to strengthen the bonds of cooperation between federal and local governments so that we can deliver great jobs, excellent schools, affordable healthcare, and safe communities for all of our people!"
"1044",1044,0,0,0,FALSE,"2020-01-25 00:28:17+00:00","https://twitter.com/March_for_Life/status/1220845061367353345"
"1045",1045,5,0,5,FALSE,"2020-01-24 21:31:52+00:00","After consultation with our Great Military Leaders, designers, and others, I am pleased to present the new logo for the United States Space Force, the Sixth Branch of our Magnificent Military!"
"1046",1046,4,4,0,TRUE,"2020-01-24 21:18:15+00:00","China has been working very hard to contain the Coronavirus. The United States greatly appreciates their efforts and transparency. It will all work out well. In particular, on behalf of the American People, I want to thank President Xi!"
"1047",1047,0,0,0,FALSE,"2020-01-24 18:11:20+00:00","#MarchForLife"
"1048",1048,2,4,-2,FALSE,"2020-01-24 16:56:24+00:00","The Do Nothing Democrats just keep repeating and repeating, over and over again, the same old “stuff” on the Impeachment Hoax. They want to use up ALL of their time, even though it is the wrong thing to do. They ought to go back to work for our great American people!"
"1049",1049,0,0,0,FALSE,"2020-01-24 16:16:09+00:00","READ THE TRANSCRIPTS!"
"1050",1050,5,10,-5,TRUE,"2020-01-24 15:37:32+00:00","More than anything else, the Radical Left, Do Nothing Democrats, like AOC, Omar, Cryin’ Chuck, Nervous Nancy & Shifty Schiff, are angry & “deranged” over the fact that Republicans are up to 191 Federal Judges & Two Great New Supreme Court Justices. Don’t blame me, blame Obama!"
"1051",1051,1,0,1,FALSE,"2020-01-24 15:11:25+00:00","Jim is great!"
"1052",1052,0,0,0,FALSE,"2020-01-24 12:58:27+00:00","Cryin’ Chuck never had what it takes, and never will!"
"1053",1053,0,8,-8,FALSE,"2020-01-24 12:50:09+00:00","The Impeachment Hoax is interfering with the 2020 Election - But that was the idea behind the Radical Left, Do Nothing Dems Scam attack. They always knew I did nothing wrong!"
"1054",1054,3,4,-1,FALSE,"2020-01-24 12:41:33+00:00","“I often get asked the question, well, isn’t the President going to be stronger and harder to beat if he survives this? The answer is yes, but, the Congress has no choice, it has a Constitutional responsibility.” Joe Biden, pres. candidate. Even Joe agrees with us! @foxandfriends"
"1055",1055,1,8,-7,FALSE,"2020-01-24 12:37:46+00:00","After having been treated unbelievably unfairly in the House, and then having to endure hour after hour of lies, fraud & deception by Shifty Schiff, Cryin’ Chuck Schumer & their crew, looks like my lawyers will be forced to start on Saturday, which is called Death Valley in T.V."
"1056",1056,4,2,2,FALSE,"2020-01-24 12:35:52+00:00","....a foreign power, engaged in clandestine intelligence activities, and yet they still asked for the renewal, two more times, and it gave the right for the government to rifle through the Trump campaigns files, & Emails, Text messages.....” So how bad & illegal is that? @FoxNews"
"1057",1057,2,0,2,TRUE,"2020-01-24 12:35:51+00:00","Frances Hakes, former Federal prosecutor, “This is really significant. The FBI had debunked the Steele Dossier in January of 2017, and then even after they did that, even after they knew from the CIA & from their own sources, they knew that Carter Page was not the agent of"
"1058",1058,1,2,-1,FALSE,"2020-01-24 11:42:37+00:00","“He’s got to explain this. How did Hunter Biden get a billion and a half dollars (from China) to invest when he’d been in business for 60 days?” @LindseyGrahamSC @FoxNews"
"1059",1059,2,2,0,FALSE,"2020-01-24 11:24:48+00:00","“21 State Attorney Generals denouncing the Impeachment of President Trump.” @FoxNews"
"1060",1060,1,2,-1,FALSE,"2020-01-24 11:18:36+00:00","Jeanne Mancini, President, March for Life: “We have never had a President of the United States actually come in person to the March for Life.” But now you do! See you later Jeanne. @HeatherChilders @FoxNews"
"1061",1061,0,0,0,FALSE,"2020-01-24 03:48:51+00:00",""
"1062",1062,0,0,0,FALSE,"2020-01-24 03:44:32+00:00",""
"1063",1063,5,0,5,FALSE,"2020-01-24 02:52:47+00:00","Carlos will win big, very exciting. Great for Florida, great for USA! He has my complete and total Endorsement!"
"1064",1064,0,0,0,FALSE,"2020-01-24 02:40:03+00:00",""
"1065",1065,0,0,0,FALSE,"2020-01-23 22:21:22+00:00","True!"
"1066",1066,1,0,1,FALSE,"2020-01-23 21:50:02+00:00","That is a real fan. Thank you!"
"1067",1067,0,0,0,FALSE,"2020-01-23 21:11:47+00:00","On my way, see you soon!"
"1068",1068,3,7,-4,FALSE,"2020-01-23 21:08:30+00:00","Crazy Bernie takes the lead in the Democrat Primaries, but it is looking more and more like the Dems will never allow him to win! Will Sleepy Joe be able to stumble across the finish line?"
"1069",1069,1,3,-2,FALSE,"2020-01-23 21:08:28+00:00","Democrats are going to destroy your Social Security. I have totally left it alone, as promised, and will save it!"
"1070",1070,1,3,-2,FALSE,"2020-01-23 21:04:47+00:00","A poll of Radical Left, Do Nothing Democrats just came out in Florida. Nice results!"
"1071",1071,1,0,1,FALSE,"2020-01-23 21:03:28+00:00","I LOVE ALABAMA!"
"1072",1072,1,0,1,FALSE,"2020-01-23 21:02:31+00:00","Interesting poll in Texas-13! #TX13"
"1073",1073,0,0,0,FALSE,"2020-01-23 21:01:35+00:00","Close race in Kansas!"
"1074",1074,1,1,0,FALSE,"2020-01-23 20:34:14+00:00","“President Trump shows us that electability is no match for electricity” by @KellyannePolls"
"1075",1075,1,4,-3,FALSE,"2020-01-23 20:26:23+00:00","“The Democrats have now conceded that President Trump has not committed a crime.” @AriFleischer"
"1076",1076,1,0,1,FALSE,"2020-01-23 19:30:13+00:00","The United States looks forward to welcoming Prime Minister @Netanyahu & Blue & White Chairman @Gantzbe to the @WhiteHouse next week. Reports about details and timing of our closely-held peace plan are purely speculative."
"1077",1077,0,6,-6,FALSE,"2020-01-23 18:18:06+00:00","The Democrats don’t want a Witness Trade because Shifty Schiff, the Biden’s, the fake Whistleblower(& his lawyer), the second Whistleblower (who vanished after I released the Transcripts), the so-called “informer”, & many other Democrat disasters, would be a BIG problem for them!"
"1078",1078,1,1,0,FALSE,"2020-01-23 16:15:29+00:00","“This is all about undermining the next Election.” Liz Peek, @FoxNews"
"1079",1079,2,3,-1,FALSE,"2020-01-23 13:25:14+00:00","....during his hopeless “presidential” campaign. They will remain silent! The fact is, when Mini losses, he will be spending very little of his money on these “clowns” because he will consider himself to be the biggest clown of them all - and he will be right!"
"1080",1080,1,9,-8,FALSE,"2020-01-23 13:25:14+00:00","Mini Mike Bloomberg is playing poker with his foolhardy and unsuspecting Democrat rivals. He says that if he loses (he really means when!) in the primaries, he will spend money helping whoever the Democrat nominee is. By doing this, he figures, they won’t hit him as hard...."
"1081",1081,0,6,-6,FALSE,"2020-01-23 12:57:46+00:00","The Democrats & Shifty Schiff, whose presentation to the Senate was loaded with lies and misrepresentations, are refusing to state that the Obama Administration withheld aid from many countries including Ukraine, Pakistan, Philippines, Egypt, Honduras, & Mexico. Witch Hunt!"
"1082",1082,1,3,-2,FALSE,"2020-01-23 12:54:28+00:00","No matter what you give to the Radical Left, Do Nothing Democrats, it will never be enough!"
"1083",1083,2,2,0,FALSE,"2020-01-23 12:52:46+00:00","The Democrat House would not give us lawyers, or not one witness, but now demand that the Republican Senate produce the witnesses that the House never sought, or even asked for? They had their chance, but pretended to rush. Most unfair & corrupt hearing in Congressional history!"
"1084",1084,3,4,-1,FALSE,"2020-01-23 12:49:16+00:00","In an Impeachment, you can’t use a work of fiction as the theory for the case, filling in gaps with presumptions against the President. It was a weak presentation, self indulgent, & he didn’t deliver the goods.” Robert Charles, @HeatherChilders @FoxNews"
"1085",1085,3,4,-1,FALSE,"2020-01-23 12:46:14+00:00","....OF THE 2020 ELECTION BECSUSE IT WEAPONIZES A PROCESS THAT SHOULD ONLY BE INITIATED IN EXCEEDINGLY RARE CIRCUMSTANCES, AND SHOULD NEVER BE USED FOR PARTISAN PURPOSES.” @HeatherChilders @FoxNews The Democrats are trying hard to damage Republicans prior to the Election!"
"1086",1086,0,9,-9,FALSE,"2020-01-23 12:45:53+00:00","Attorney Generals from 21 States are urging the Senate to reject Impeachment. They say the Articles have legal & factual problems, and the Democrats case sets a dangerous historical precedent. “EVEN AN UNSUCCESSFUL EFFORT TO IMPEACH THE PRESIDENT UNDERMINES THE INTEGRITY....."
"1087",1087,0,1,-1,FALSE,"2020-01-23 12:42:08+00:00","“There is no evidence of a crime.” Robert Charles, Fmr Asst Secy of State. The crimes were committed by the other side!"
"1088",1088,1,1,0,FALSE,"2020-01-23 12:39:17+00:00","“Schiff doesn’t have a case telling the truth, so he’s manufacturing things.” Rush Limbaugh @foxandfriends"
"1089",1089,0,1,-1,FALSE,"2020-01-22 22:13:16+00:00","Sorry, if you come you will be immediately sent back!"
"1090",1090,0,0,0,FALSE,"2020-01-22 22:04:40+00:00","See you on Friday...Big Crowd!"
"1091",1091,0,0,0,FALSE,"2020-01-22 21:43:19+00:00","True!"
"1092",1092,0,0,0,FALSE,"2020-01-22 19:58:40+00:00","“NO PRESSURE”"
"1093",1093,1,0,1,FALSE,"2020-01-22 19:12:11+00:00","Will be Great!"
"1094",1094,1,0,1,FALSE,"2020-01-22 19:08:07+00:00","Great working with you Maria!"
"1095",1095,4,3,1,FALSE,"2020-01-22 18:03:06+00:00","One of the many great things about our just signed giant Trade Deal with China is that it will bring both the USA & China closer together in so many other ways. Terrific working with President Xi, a man who truly loves his country. Much more to come!"
"1096",1096,1,0,1,FALSE,"2020-01-22 16:21:27+00:00","Heading back to Washington from @Davos , Switzerland. Very successful (for USA) trip!"
"1097",1097,1,3,-2,FALSE,"2020-01-22 16:17:33+00:00","“Not the Senate’s job to mop up the mess made in the House by the Democrats. Biden admitted that he went to Ukraine and did the Quid Pro Quo.” @SteveScalise @FoxNews"
"1098",1098,1,0,1,FALSE,"2020-01-22 16:01:53+00:00","THANK YOU @WEF!"
"1099",1099,0,1,-1,FALSE,"2020-01-22 13:26:39+00:00","They are taking the nomination away from Bernie for a second time. Rigged!"
"1100",1100,0,2,-2,FALSE,"2020-01-22 13:23:33+00:00","Steyer is a major loser. Just doesn’t get it. This is second time with Bernie!"
"1101",1101,0,1,-1,FALSE,"2020-01-22 12:55:53+00:00","Big story. Hope Fake News covers it!"
"1102",1102,0,1,-1,FALSE,"2020-01-22 12:43:56+00:00","Their case was so “overwhelming” in the House that they need & demand Witnesses in the Senate!"
"1103",1103,1,0,1,FALSE,"2020-01-22 09:34:38+00:00","ENJOY!"
"1104",1104,1,0,1,FALSE,"2020-01-22 09:32:48+00:00","Will be interviewed at 5:00 A.M. Eastern by @JoeSquawk on @CNBC at the World Economic Forum in Davos, Switzerland. Enjoy!"
"1105",1105,4,0,4,FALSE,"2020-01-22 06:48:31+00:00","Making great progress in @Davos. Tremendous numbers of companies will be coming, or returning, to the USA. Hottest Economy! JOBS, JOBS, JOBS!"
"1106",1106,1,0,1,FALSE,"2020-01-22 05:29:16+00:00","Wow!"
"1107",1107,0,0,0,FALSE,"2020-01-21 19:08:04+00:00","READ THE TRANSCRIPTS!"
"1108",1108,2,0,2,FALSE,"2020-01-21 13:25:01+00:00","Congratulations on your big @UFC WIN!"
"1109",1109,1,0,1,FALSE,"2020-01-21 01:59:50+00:00","THE BEST IS YET TO COME!"
"1110",1110,4,4,0,FALSE,"2020-01-21 01:45:51+00:00","“It’s about the Economy, stupid”, except when it comes to Trump. The fact is, the Fake News Media hates talking about the Economy, and how incredible it is!"
"1111",1111,1,0,1,FALSE,"2020-01-21 01:36:43+00:00","Everyone said it couldn’t be done. But for the first time in a generation, there will be direct flights between Serbia and Kosovo. Another win. Thanks to @WHNSC Ambassador Robert O’Brien and Ambassador @RichardGrenell!"
"1112",1112,6,2,4,FALSE,"2020-01-21 01:26:55+00:00","Representative Randy Weber (@TxRandy14) of Texas has been a HUGE supporter of our #MAGA Agenda from the very beginning. Strong on Crime, the Border, Illegal Immigration, the 2nd Amendment, and our great Military & Vets! Randy has my Full Endorsement!"
"1113",1113,8,1,7,FALSE,"2020-01-21 01:26:11+00:00","Representative John Carter (@JudgeJohnCarter) from the Great State of Texas has been a tremendous supporter of our #MAGA Agenda. He is strong on Crime and Borders, great for our Military and our Vets, and Strong on our #2A. John has my Complete and Total Endorsement!"
"1114",1114,7,2,5,FALSE,"2020-01-21 01:24:20+00:00","Texas Rep Roger Williams (@RepRWilliams) has done an incredible job representing the Great State of Texas. Roger is tough on Crime, Strong on the Border & Illegal Immigration. He loves our Military & our Vets and protects our #2A. Roger has my Total & Complete Endorsement!"
"1115",1115,2,0,2,FALSE,"2020-01-21 00:59:38+00:00","Heading to Davos, Switzerland, to meet with World and Business Leaders and bring Good Policy and additional Hundreds of Billions of Dollars back to the United States of America! We are now NUMBER ONE in the Universe, by FAR!!"
"1116",1116,1,0,1,FALSE,"2020-01-21 00:46:13+00:00","Excellent!"
"1117",1117,0,0,0,FALSE,"2020-01-20 23:32:31+00:00",""
"1118",1118,2,3,-1,FALSE,"2020-01-20 23:03:10+00:00","Nancy can’t fix it. The Do Nothing Dems have done great harm to our Country!"
"1119",1119,1,0,1,FALSE,"2020-01-20 20:12:03+00:00","I will NEVER allow our great Second Amendment to go unprotected, not even a little bit!"
"1120",1120,5,1,4,FALSE,"2020-01-20 19:59:40+00:00","It was exactly three years ago today, January 20, 2017, that I was sworn into office. So appropriate that today is also MLK jr DAY. African-American Unemployment is the LOWEST in the history of our Country, by far. Also, best Poverty, Youth, and Employment numbers, ever. Great!"
"1121",1121,1,0,1,FALSE,"2020-01-20 18:53:02+00:00","...And they say you can add 7% to 10% to all Trump numbers! Who knows?"
"1122",1122,1,7,-6,FALSE,"2020-01-20 18:48:44+00:00","Two stone cold losers from Amazon WP. Almost every story is a made up lie, just like corrupt pol Shifty Schiff, who fraudulently made up my call with Ukraine. Fiction!"
"1123",1123,0,0,0,FALSE,"2020-01-20 17:04:17+00:00","USA! USA! USA!"
"1124",1124,3,1,2,FALSE,"2020-01-20 15:52:48+00:00","Cryin’ Chuck Schumer is now asking for “fairness”, when he and the Democrat House members worked together to make sure I got ZERO fairness in the House. So, what else is new?"
"1125",1125,0,0,0,FALSE,"2020-01-20 15:47:41+00:00","They didn’t want John Bolton and others in the House. They were in too much of a rush. Now they want them all in the Senate. Not supposed to be that way!"
"1126",1126,2,2,0,FALSE,"2020-01-20 15:43:57+00:00","The Democrat Party in the Great Commonwealth of Virginia are working hard to take away your 2nd Amendment rights. This is just the beginning. Don’t let it happen, VOTE REPUBLICAN in 2020!"
"1127",1127,2,0,2,FALSE,"2020-01-20 01:57:49+00:00","A great show! Check it out tonight at 9pm. @FoxNews"
"1128",1128,1,2,-1,FALSE,"2020-01-20 01:16:00+00:00","“In the House, the President got less due process than the 9-11 terrorists got. This is a corrupt process?” Mark Levin @marklevinshow “Very much so!” @RepDougCollins @FoxNews"
"1129",1129,8,0,8,FALSE,"2020-01-20 00:27:07+00:00","I was thrilled to be back in the Great State of Texas tonight, where the people are known for being tough, strong, hardworking, loyal and fiercely patriotic — just like America’s incredible Farmers! #AFBF2020"
"1130",1130,2,8,-6,FALSE,"2020-01-19 21:12:20+00:00","Now Mini Mike Bloomberg is critical of Jack Wilson, who saved perhaps hundreds of people in a Church because he was carrying a gun, and knew how to use it. Jack quickly killed the shooter, who was beginning a rampage. Mini is against the 2nd A. His ads are Fake, just like him!"
"1131",1131,4,0,4,FALSE,"2020-01-19 18:24:52+00:00","I have never seen the Republican Party as Strong and as Unified as it is right now. Thank you!"
"1132",1132,4,2,2,FALSE,"2020-01-19 17:44:56+00:00","I will be going to Austin, Texas. Leaving soon. Always like (love!) being in the Lone Star State. Speaking to our great Farmers. They hit “paydirt” with our incredible new Trade Deals: CHINA, JAPAN, MEXICO, CANADA, SOUTH KOREA, and many others!"
"1133",1133,0,0,0,FALSE,"2020-01-19 04:30:52+00:00",""
"1134",1134,3,6,-3,FALSE,"2020-01-19 02:12:28+00:00","“Nancy Pelosi said, it’s not a question of proof, it’s a question of allegations! Oh really?” @JudgeJeanine @FoxNews What a disgrace this Impeachment Scam is for our great Country!"
"1135",1135,1,5,-4,FALSE,"2020-01-19 00:52:42+00:00","If you listened to the flawed advice of @paulkrugman at the @nytimes, a newspaper that was going broke until I came along, you would have entirely missed the RECORD BREAKING Stock Market (and other) numbers produced since Election Day, 2016. Sorry, those are the FACTS....."
"1136",1136,1,0,1,FALSE,"2020-01-19 00:52:28+00:00","....BUT THE BEST IS YET TO COME!"
"1137",1137,3,6,-3,FALSE,"2020-01-18 23:18:22+00:00","A massive 200 Billion Dollar Sea Wall, built around New York to protect it from rare storms, is a costly, foolish & environmentally unfriendly idea that, when needed, probably won’t work anyway. It will also look terrible. Sorry, you’ll just have to get your mops & buckets ready!"
"1138",1138,6,6,0,FALSE,"2020-01-18 23:16:21+00:00","Another Fake Book by two third rate Washington Post reporters, has already proven to be inaccurately reported, to their great embarrassment, all for the purpose of demeaning and belittling a President who is getting great things done for our Country, at a record clip. Thank you!"
"1139",1139,1,3,-2,FALSE,"2020-01-18 22:58:25+00:00","They are taking the Democrat Nomination away from Crazy Bernie, just like last time. Some things never change!"
"1140",1140,4,0,4,FALSE,"2020-01-18 22:56:19+00:00","95% Approval Rating in the Republican Party, A Record. Thank You!"
"1141",1141,2,0,2,FALSE,"2020-01-18 13:35:26+00:00","“Trade Deals Drive Stocks To Record Highs.” @FoxNews"
"1142",1142,4,0,4,FALSE,"2020-01-18 13:33:13+00:00","“Day after day, really good news on the economy. By the way, this didn’t just happen by accident, it’s the result of a lot of the policies that Donald Trump has put into place. Obviously, the Tax Cut, and now we have these two BIG trade deals.” @StephenMoore Great future growth!"
"1143",1143,0,0,0,FALSE,"2020-01-18 13:19:20+00:00","Tremendous surge in new housing construction in December, 16.9%, biggest in many years!"
"1144",1144,1,0,1,FALSE,"2020-01-18 13:09:51+00:00","A great day at the White House for our National Champions, the LSU Tigers!"
"1145",1145,1,0,1,FALSE,"2020-01-18 00:57:56+00:00","CONGRATULATIONS! #GeauxTigers"
"1146",1146,0,0,0,FALSE,"2020-01-17 23:10:50+00:00","مردم نجیب ایران، که آمریکا را دوست می دارند، سزاوار دولتی هستند که بیش از تمرکز بر کشتن آنها به جرم احترام خواهی، به آنها کمک کند تا به رؤیاهایشان دست یابند. رهبران ایران به جای آن که ایران را به سمت ویرانی بکشانند، باید هراس افکنی را کنار بنهند و ایران را دوباره باعظمت کنند!"
"1147",1147,7,6,1,FALSE,"2020-01-17 23:10:21+00:00","The noble people of Iran—who love America—deserve a government that's more interested in helping them achieve their dreams than killing them for demanding respect. Instead of leading Iran toward ruin, its leaders should abandon terror and Make Iran Great Again!"
"1148",1148,3,4,-1,FALSE,"2020-01-17 22:22:05+00:00","The so-called “Supreme Leader” of Iran, who has not been so Supreme lately, had some nasty things to say about the United States and Europe. Their economy is crashing, and their people are suffering. He should be very careful with his words!"
"1149",1149,4,3,1,FALSE,"2020-01-17 22:22:05+00:00","Your 2nd Amendment is under very serious attack in the Great Commonwealth of Virginia. That’s what happens when you vote for Democrats, they will take your guns away. Republicans will win Virginia in 2020. Thank you Dems!"
"1150",1150,2,0,2,FALSE,"2020-01-17 22:22:04+00:00","Words of wisdom. Thank you Ted!"
"1151",1151,2,0,2,FALSE,"2020-01-17 20:10:15+00:00","Heading to Florida for big Republican Party event. New Stock Market Record. Jobs in USA at all-time high!"
"1152",1152,1,4,-3,FALSE,"2020-01-17 15:35:04+00:00","....Joe Biden, and Bernie is shut out again. Very unfair, but that’s the way the Democrats play the game. Anyway, it’s a lot of fun to watch!"
"1153",1153,3,7,-4,FALSE,"2020-01-17 15:35:00+00:00","They are rigging the election again against Bernie Sanders, just like last time, only even more obviously. They are bringing him out of so important Iowa in order that, as a Senator, he sit through the Impeachment Hoax Trial. Crazy Nancy thereby gives the strong edge to Sleepy..."
"1154",1154,5,0,5,FALSE,"2020-01-17 15:17:43+00:00","Getting ready to meet the LSU Tigers, the National Champions. Great Coach, great Team, great School. Very exciting!"
"1155",1155,4,5,-1,FALSE,"2020-01-17 14:12:06+00:00","Mini Mike Bloomberg ads are purposely wrong - A vanity project for him to get into the game. Nobody in many years has done for the USA what I have done for the USA, including the greatest economy in history, rebuilding our military, biggest ever tax & regulation cuts, & 2nd A!"
"1156",1156,0,5,-5,FALSE,"2020-01-17 13:39:21+00:00","Mini Mike Bloomberg doesn’t get on the Democrat Debate Stage because he doesn’t want to - he is a terrible debater and speaker. If he did, he would go down in the polls even more (if that is possible!)."
"1157",1157,2,3,-1,FALSE,"2020-01-17 13:34:27+00:00","“There is no crime here. Entertaining this Impeachment is a joke. This whole thing should be dismissed.” @IngrahamAngle @FoxNews"
"1158",1158,3,2,1,FALSE,"2020-01-17 13:33:09+00:00","“Years from now, when we look back at this day, nobody’s going to remember Nancy’s cheap theatrics, they will remember though how President Trump brought the Chinese to the bargaining table and delivered achievements few ever thought were possible.” @IngrahamAngle @FoxNews"
"1159",1159,1,1,0,FALSE,"2020-01-17 13:32:08+00:00","....for the foreign policies of the President.” @AlanDersh Alan Dershowitz @seanhannity @FoxNews They do what the House asks. The Swamp!"
"1160",1160,0,1,-1,FALSE,"2020-01-17 13:32:05+00:00","“The GOA got it exactly backwards. Here’s what they said. The law does not permit the President to substitute his own policy priorities to those Congress has enacted into law. It’s exactly the opposite. The Constitution does not allow Congress to substitute its own priorities...."
"1161",1161,2,0,2,FALSE,"2020-01-17 01:41:52+00:00","PROMISES MADE, PROMISES KEPT! #KeepAmericaGreat2020 "
"1162",1162,0,0,0,FALSE,"2020-01-17 00:22:43+00:00","See you tomorrow! #CHAMPS"
"1163",1163,2,0,2,FALSE,"2020-01-16 21:50:50+00:00","THANK YOU! #MAGA"
"1164",1164,1,0,1,FALSE,"2020-01-16 20:39:23+00:00","I JUST GOT IMPEACHED FOR MAKING A PERFECT PHONE CALL!"
"1165",1165,0,1,-1,FALSE,"2020-01-16 15:59:19+00:00","Amazon Calls 'Profiles in Corruption' the 'Most Anticipated' Nonfiction Book http://bit.ly/2tlBT7y via @BreitbartNews"
"1166",1166,1,1,0,FALSE,"2020-01-16 15:49:37+00:00","This is a total disgrace, but just another reason that I’m going to win Michigan again!"
"1167",1167,0,0,0,FALSE,"2020-01-16 15:23:26+00:00","Looking at this strongly!"
"1168",1168,2,1,1,FALSE,"2020-01-16 15:14:29+00:00","The farmers are really happy with the new China Trade Deal and the soon to be signed deal with Mexico and Canada, but I hope the thing they will most remember is the fact that I was able to take massive incoming Tariff money and use it to help them get through the tough times!"
"1169",1169,2,5,-3,FALSE,"2020-01-16 15:04:51+00:00","“There is no crime here. I just think this whole thing should be rejected out of hand. I wouldn’t waste a minute of taxpayer dollars or time on this. Entertaining this Impeachment is a joke.” Laura Ingraham @IngrahamAngle @FoxNews"
"1170",1170,2,3,-1,FALSE,"2020-01-16 13:59:15+00:00","Cryin’ Chuck Schumer is saying privately that the new China Trade Deal is unbelievable, which it is, but publicly he knocks it whenever possible. That’s politics, but so bad for our great Country!"
"1171",1171,6,1,5,FALSE,"2020-01-16 13:41:21+00:00","One of the greatest trade deals ever made! Also good for China and our long term relationship. 250 Billion Dollars will be coming back to our Country, and we are now in a great position for a Phase Two start. There has never been anything like this in U.S. history! USMCA NEXT!"
"1172",1172,0,0,0,FALSE,"2020-01-16 00:51:39+00:00","https://twitter.com/WaysandMeansGOP/status/1217508926872334336"
"1173",1173,1,1,0,FALSE,"2020-01-15 15:33:21+00:00","Here we go again, another Con Job by the Do Nothing Democrats. All of this work was supposed to be done by the House, not the Senate!"
"1174",1174,1,1,0,FALSE,"2020-01-15 06:13:50+00:00","I agree with him on this, 100%. But why would anyone vote Democrat? We are setting all time records with the economy!"
"1175",1175,5,0,5,TRUE,"2020-01-15 05:45:31+00:00","Now up to 187 Federal Judges, and two great new Supreme Court Justices. We are in major record territory. Hope EVERYONE is happy!"
"1176",1176,0,1,-1,FALSE,"2020-01-15 04:46:25+00:00","Steyer is running low on cash. Nobody knows him. Made his money on coal. So funny!"
"1177",1177,1,1,0,FALSE,"2020-01-15 04:32:01+00:00","Prime Minister of the United Kingdom, @BorisJohnson, stated, “We should replace the Iran deal with the Trump deal.” I agree!"
"1178",1178,3,2,1,FALSE,"2020-01-15 03:18:03+00:00","Former National Security Adviser for President Obama said “President Trump was absolutely correct” in taking out terroristist leader Soleimani. Thank you General Jones!"
"1179",1179,3,0,3,FALSE,"2020-01-15 02:53:55+00:00","Republicans are fighting for citizens from every background, & from every race, religion, color & creed. We are a movement for ALL AMERICANS who believe in fairness & justice, equality & dignity, opportunity & safety. We are a big tent, & a big party, w/ BIG IDEAS for the future!"
"1180",1180,1,4,-3,FALSE,"2020-01-15 02:49:47+00:00","Democrats are now the party of high taxes, high crime, open borders, late-term abortion, socialism, and blatant corruption. The Republican Party is the party of the American Worker, the American Family, and the American Dream! #TrumpMilwaukeeRally"
"1181",1181,1,0,1,FALSE,"2020-01-15 02:43:27+00:00","GOD BLESS THE U.S.A.!"
"1182",1182,3,0,3,FALSE,"2020-01-15 02:36:27+00:00","Thank you Milwaukee, Wisconsin! #KAG2020 #MAGA"
"1183",1183,3,5,-2,FALSE,"2020-01-14 23:45:49+00:00","Cryin’ Chuck Schumer just said, “The American people want a fair trial in the Senate.” True, but why didn’t Nervous Nancy and Corrupt politician Adam “Shifty” Schiff give us a fair trial in the House. It was the most lopsided & unfair basement hearing in the history of Congress!"
"1184",1184,5,4,1,FALSE,"2020-01-14 23:36:13+00:00","We are helping Apple all of the time on TRADE and so many other issues, and yet they refuse to unlock phones used by killers, drug dealers and other violent criminal elements. They will have to step up to the plate and help our great Country, NOW! MAKE AMERICA GREAT AGAIN."
"1185",1185,0,0,0,FALSE,"2020-01-14 23:16:43+00:00","On my way to Milwaukee, Wisconsin for a #TrumpRally. Look forward to see you all soon!"
"1186",1186,1,0,1,FALSE,"2020-01-14 05:52:01+00:00","Thank you!"
"1187",1187,1,3,-2,FALSE,"2020-01-14 05:25:32+00:00","Thank you to Rick Scott. This Impeachment Hoax is an outrage!"
"1188",1188,2,2,0,FALSE,"2020-01-13 23:58:04+00:00","I stand stronger than anyone in protecting your Healthcare with Pre-Existing Conditions. I am honored to have terminated the very unfair, costly and unpopular individual mandate for you!"
"1189",1189,2,4,-2,FALSE,"2020-01-13 17:31:58+00:00","“We demand fairness” shouts Pelosi and the Do Nothing Democrats, yet the Dems in the House wouldn’t let us have 1 witness, no lawyers or even ask questions. It was the most unfair witch-hunt in the history of Congress!"
"1190",1190,1,3,-2,FALSE,"2020-01-13 16:13:50+00:00","Really Big Breaking News (Kidding): Booker, who was in zero polling territory, just dropped out of the Democrat Presidential Primary Race. Now I can rest easy tonight. I was sooo concerned that I would someday have to go head to head with him!"
"1191",1191,1,6,-5,FALSE,"2020-01-13 16:09:17+00:00","The Fake News Media and their Democrat Partners are working hard to determine whether or not the future attack by terrorist Soleimani was “imminent” or not, & was my team in agreement. The answer to both is a strong YES., but it doesn’t really matter because of his horrible past!"
"1192",1192,4,3,1,FALSE,"2020-01-13 15:53:40+00:00","Wow! The wonderful Iranian protesters refused to step on, or in any way denigrate, our Great American Flag. It was put on the street in order for them to trample it, and they walked around it instead. Big progress!"
"1193",1193,3,4,-1,FALSE,"2020-01-13 15:47:16+00:00","The Democrats and the Fake News are trying to make terrorist Soleimani into a wonderful guy, only because I did what should have been done for 20 years. Anything I do, whether it’s the economy, military, or anything else, will be scorned by the Rafical Left, Do Nothing Democrats!"
"1194",1194,1,6,-5,FALSE,"2020-01-13 15:25:26+00:00","Bernie Sander’s volunteers are trashing Elizabeth “Pocahontus” Warren. Everybody knows her campaign is dead and want her potential voters. Mini Mike B is also trying, but getting tiny crowds which are all leaving fast. Elizabeth is very angry at Bernie. Do I see a feud brewing?"
"1195",1195,5,1,4,FALSE,"2020-01-13 13:39:20+00:00","....and, if Republicans win in court and take back the House of Represenatives, your healthcare, that I have now brought to the best place in many years, will become the best ever, by far. I will always protect your Pre-Existing Conditions, the Dems will not!"
"1196",1196,1,6,-5,FALSE,"2020-01-13 13:39:15+00:00","Mini Mike Bloomberg is spending a lot of money on False Advertising. I was the person who saved Pre-Existing Conditions in your Healthcare, you have it now, while at the same time winning the fight to rid you of the expensive, unfair and very unpopular Individual Mandate....."
"1197",1197,0,0,0,FALSE,"2020-01-13 02:00:30+00:00","مشاور امنیت ملی امروز عنوان کرد كه تحریم ها و اعتراضات، ایران را«به شدت تحت فشار»قرار داده است و آنها را مجبور به مذاكره می كند.در واقع، اصلا برایم اهمیتی نداردکه آیا آنها مذاکره می کنند یا نه.این کاملاً به عهده ی خودشان است، اما سلاح هسته ای نداشته باشیدو«معترضان خود را نکشید.»"
"1198",1198,0,3,-3,FALSE,"2020-01-12 23:46:18+00:00","National Security Adviser suggested today that sanctions & protests have Iran “choked off”, will force them to negotiate. Actually, I couldn’t care less if they negotiate. Will be totally up to them but, no nuclear weapons and “don’t kill your protesters.”"
"1199",1199,1,6,-5,FALSE,"2020-01-12 19:55:08+00:00","Many believe that by the Senate giving credence to a trial based on the no evidence, no crime, read the transcripts, “no pressure” Impeachment Hoax, rather than an outright dismissal, it gives the partisan Democrat Witch Hunt credibility that it otherwise does not have. I agree!"
"1200",1200,0,0,0,FALSE,"2020-01-12 19:38:25+00:00",""
"1201",1201,0,0,0,FALSE,"2020-01-12 19:37:58+00:00",""
"1202",1202,0,0,0,FALSE,"2020-01-12 19:37:02+00:00",""
"1203",1203,2,3,-1,FALSE,"2020-01-12 19:02:01+00:00","Wow! Crazy Bernie Sanders is surging in the polls, looking very good against his opponents in the Do Nothing Party. So what does this all mean? Stay tuned!"
"1204",1204,2,1,1,FALSE,"2020-01-12 18:41:13+00:00","You can’t make this up! David Kris, a highly controversial former DOJ official, was just appointed by the FISA Court to oversee reforms to the FBI’s surveillance procedures. Zero credibility. THE SWAMP! @DevinNunes @MariaBartiromo @FoxNews"
"1205",1205,2,4,-2,FALSE,"2020-01-12 18:29:19+00:00","....the Ukraine Hoax that became the Impeachment Scam. Must get the ICIG answers by Friday because this is the guy who lit the fuse. So if he wants to clear his name, prove that his office is indeed incompetent.” @DevinNunes @MariaBartiromo @FoxNews The ICIG never wanted proof!"
"1206",1206,2,5,-3,FALSE,"2020-01-12 18:29:17+00:00","House Republicans investigating origins of the Ukraine Whistleblower complaint. ICIG Michael Atkinson facing serious questions. “The Democrats know the ICIG is a major problem-didn’t release his testimony. Looks so much like everything else we’ve seen, from the Russia Hoax, to..."
"1207",1207,0,0,0,FALSE,"2020-01-12 16:44:28+00:00","خطاب به رهبران ايران: معترضان خود را نكشيد. هزاران تن تاكنون به دست شما كشته يا زنداني شده اند، و جهان نظاره گر است. مهمتر از ان، ايالات متحده نظاره گر است. اينترنت را دوباره وصل كنيد و به خبرنگاران اجازه دهيد ازادانه حركت كنند! كشتار مردم بزرگ ايران را متوقف كنيد!"
"1208",1208,2,6,-4,FALSE,"2020-01-12 16:40:18+00:00","Why should I have the stigma of Impeachment attached to my name when I did NOTHING wrong? Read the Transcripts! A totally partisan Hoax, never happened before. House Republicans voted 195-0, with three Dems voting with the Republicans. Very unfair to tens of millions of voters!"
"1209",1209,0,6,-6,FALSE,"2020-01-12 16:13:56+00:00","Why did Nervous Nancy allow corrupt politician Shifty Schiff to lie before Congress? He must be a Witness, and so should she!"
"1210",1210,2,5,-3,FALSE,"2020-01-12 15:30:20+00:00","Great idea. This phony Impeachment Hoax should not even be allowed to proceed. Did NOTHING wrong. Just a partisan vote. Zero Republicans. Never happened before!"
"1211",1211,1,9,-8,FALSE,"2020-01-12 15:25:08+00:00","“Pelosi has made a mockery of Impeachment. Her Articles are so weak. But more importantly, she thought she could extort the Senate. She couldn’t.” @GreggJarrett @foxandfriends The Do Nothing Democrats are really run by the Radical Left. Too bad!"
"1212",1212,3,0,3,FALSE,"2020-01-12 14:26:51+00:00","....discretion, and only as a last resort.” Thank you to the great Michael Goodwin. Could not have said it better myself!"
"1213",1213,6,1,5,FALSE,"2020-01-12 14:26:51+00:00","....and then helped to fund them...And zero progress was made on curbing those activities, until Trump droned Soleimani...Plainly, Trump is not a warmonger. He’s a deal maker & his record is that of someone who uses our military might as a deterrent, unleashes it with...."
"1214",1214,3,2,1,FALSE,"2020-01-12 14:26:50+00:00","Michael Goodwin, New York Post: “Trump’s peace through strength philosophy is what America needs. His (John Kerry) claim bears no relation to reality. The Agreement didn’t create opportunities for America & other signatories to confront Iran’s malign activities. It overlooked...."
"1215",1215,1,6,-5,FALSE,"2020-01-12 14:06:03+00:00","John Kerry got caught essentially admitting that funds given ridiculously to Iran were used to fund attacks on the USA. Only a complete fool would have given that 150 Billion Dollars Plus to Iran. They then went on a Middle East Rampage! @foxandfriends @PeteHegseth"
"1216",1216,1,7,-6,FALSE,"2020-01-12 13:58:09+00:00","George @GStephanopoulos, ask Crazy Nancy why she allowed Adam “Shifty” Schiff to totally make up my conversation with the Ukrainian President & read his false words to Congress and the world, as though I said it? He got caught! Ask why hearing was most unfair & biased in history?"
"1217",1217,2,5,-3,FALSE,"2020-01-12 13:48:30+00:00","To the leaders of Iran - DO NOT KILL YOUR PROTESTERS. Thousands have already been killed or imprisoned by you, and the World is watching. More importantly, the USA is watching. Turn your internet back on and let reporters roam free! Stop the killing of your great Iranian people!"
"1218",1218,3,0,3,FALSE,"2020-01-12 13:28:34+00:00","Congratulations to @serenawilliams on another big win. She is a great player and an even greater person. Our members in Virginia (Tennis) will never forget you!"
"1219",1219,4,0,4,FALSE,"2020-01-12 13:13:44+00:00","Congratulations to the Great State of Tennessee. You’ve got yourselves a fantastic football team. Big WIN last night!"
"1220",1220,1,0,1,FALSE,"2020-01-12 04:19:03+00:00","Thank you Rudy! @JudgeJeanine"
"1221",1221,2,1,1,FALSE,"2020-01-12 04:12:21+00:00","I hope the House and Senate Democrats, in particular watch this. It is a classic. Thank you to @JudgeJeanine Pirro!"
"1222",1222,0,0,0,FALSE,"2020-01-12 04:07:54+00:00",""
"1223",1223,0,0,0,FALSE,"2020-01-11 22:50:01+00:00","دولت ایران باید به گروه‌های حقوق بشر اجازه بدهد حقیقت کنونی اعتراضات در جریان مردم ایران را نظارت کرده و گزارش بدهند. نباید شاهد کشتار دوباره ی معترضان مسالمت آمیز و یا قطع اینترنت باشیم. جهان نظاره گر این اتفاقات است."
"1224",1224,1,3,-2,FALSE,"2020-01-11 22:11:03+00:00","The government of Iran must allow human rights groups to monitor and report facts from the ground on the ongoing protests by the Iranian people. There can not be another massacre of peaceful protesters, nor an internet shutdown. The world is watching."
"1225",1225,0,0,0,FALSE,"2020-01-11 21:46:26+00:00","به مردم شجاع و رنج کشیده ایران: من از ابتدای دوره ریاست جمهوریم با شما ایستاده‌ام و دولت من همچنان با شما خواهد ایستاد. ما اعتراضات شما را از نزدیک دنبال می کنیم. شجاعت شما الهام بخش است."
"1226",1226,2,3,-1,FALSE,"2020-01-11 21:46:18+00:00","To the brave, long-suffering people of Iran: I've stood with you since the beginning of my Presidency, and my Administration will continue to stand with you. We are following your protests closely, and are inspired by your courage."
"1227",1227,2,5,-3,FALSE,"2020-01-11 21:13:47+00:00","The powerful Trump Wall is replacing porous, useless and ineffective barriers in the high traffic areas requested by Border Patrol. Illegal crossing are dropping as more and more Wall is being completed! #BuildingTheWall"
"1228",1228,6,0,6,FALSE,"2020-01-11 14:35:53+00:00","95% Approval Rating in the Republican Party, a record. 53% Approval Rating overall (can we add 7 to 10 percent because of the Trump “thing?”). Thank you!"
"1229",1229,2,5,-3,FALSE,"2020-01-11 14:29:38+00:00","Now the Radical Left, Do Nothing Democrats, are asking @senatemajldr Mitch McConnell to do the job that they were unable to do. They proved NOTHING but my total innocence in the House, despite the most unfair & biased hearings in the history of Congress. Now they demand fairness!"
"1230",1230,1,3,-2,FALSE,"2020-01-11 14:17:50+00:00","Nancy Pelosi will go down as the absolute worst Speaker of the House in U.S. history!"
"1231",1231,0,4,-4,FALSE,"2020-01-11 14:15:22+00:00","New polling shows that the totally partisan Impeachment Hoax is going nowhere. A vast majority want the Do Nothing Democrats to move on to other things now!"
"1232",1232,1,7,-6,FALSE,"2020-01-11 14:07:38+00:00","Where have the Radical Left, Do Nothing Democrats gone when they have spent the last 3 days defending the life of Qassem Soleimani, one of the worst terrorists in history and the father of the roadside bomb? He was also looking to do big future damage! Dems are “unhinged.”"
"1233",1233,1,5,-4,FALSE,"2020-01-11 13:38:13+00:00","“FBI Director apologizes for FISA Errors (of which there were far to many to be a coincidence!).” @FoxNews Chris, what about all of the lives that were ruined because of the so-called “errors?” Are these “dirty cops” going to pay a big price for the fraud they committed?"
"1234",1234,2,0,2,FALSE,"2020-01-10 23:32:11+00:00","Will be interviewed tonight by Laura @IngrahamAngle at 10pmE on @FoxNews. Enjoy!"
"1235",1235,2,0,2,FALSE,"2020-01-10 15:37:36+00:00","She will go down as perhaps the least successful Speaker in U.S. History!"
"1236",1236,3,1,2,FALSE,"2020-01-10 15:31:27+00:00","I love constantly proving them wrong. It’s easy!"
"1237",1237,3,0,3,FALSE,"2020-01-10 15:11:46+00:00","“I’ve been doing this for 40 years and I’ve never seen anything like this (Economy).” @Varneyco @foxandfriends"
"1238",1238,4,1,3,FALSE,"2020-01-10 15:08:14+00:00","“11,000 points gained in the Dow in the 3 years since the Election of President Trump. Today it may hit 29,000. That has NEVER happened before in that time frame. That has added 12.8 Trillion Dollars to the VALUE of American Business.” @Varneyco @FoxNews The best is yet to come!"
"1239",1239,1,0,1,FALSE,"2020-01-10 13:39:42+00:00","We will get this done for our great Miners!"
"1240",1240,1,1,0,FALSE,"2020-01-10 13:27:38+00:00","Thank you Mike!"
"1241",1241,1,0,1,FALSE,"2020-01-10 13:25:44+00:00","I agree. Jovita will do a great job!"
"1242",1242,5,0,5,FALSE,"2020-01-10 13:04:07+00:00","Great interview this morning by @foxandfriends with some of the fantastic people who attended the big Rally last night in Toledo, Ohio. Thank you. Such amazing energy!"
"1243",1243,2,0,2,FALSE,"2020-01-10 12:55:27+00:00","Wow! Thank you Greg. Hope I live up to your expectations."
"1244",1244,2,4,-2,FALSE,"2020-01-10 02:15:31+00:00","Democrats are now the party of high taxes, high crime, open borders, late-term abortion, socialism, and blatant corruption. The Republican Party is the party of the American Worker, the American Family, and the American Dream! #KAG2020"
"1245",1245,2,0,2,FALSE,"2020-01-10 02:07:24+00:00","After years of rebuilding OTHER nations, we are finally rebuilding OUR nation. We are finally putting AMERICA FIRST! #KAG2020"
"1246",1246,1,5,-4,FALSE,"2020-01-10 02:04:08+00:00","Under my administration, we will NEVER make excuses for America’s enemies – we will never hesitate in defending American lives – and we will never stop working to defeat Radical Islamic Terrorism!"
"1247",1247,1,0,1,FALSE,"2020-01-10 01:57:45+00:00","THANK YOU TOLEDO, OHIO!"
"1248",1248,1,0,1,FALSE,"2020-01-09 22:55:41+00:00","Heading to Toledo, Ohio, for first Rally of the year. Tremendous crowd. Here we go for a big 2020 Win!"
"1249",1249,3,0,3,FALSE,"2020-01-09 22:49:55+00:00","95% Approval Rating in the Republican Party. Thank you!"
"1250",1250,1,0,1,FALSE,"2020-01-09 22:34:17+00:00","Smart analysis, I fully agree!"
"1251",1251,1,0,1,FALSE,"2020-01-09 22:10:22+00:00","Thank you!"
"1252",1252,1,0,1,FALSE,"2020-01-09 17:59:20+00:00","Happy National Law Enforcement Appreciation Day! #LESM"
"1253",1253,0,1,-1,FALSE,"2020-01-09 15:47:49+00:00","STOCK MARKET AT ALL-TIME HIGH! HOW ARE YOUR 401K’S DOING? 70%, 80%, 90% up? Only 50% up! What are you doing wrong?"
"1254",1254,2,2,0,FALSE,"2020-01-09 15:00:36+00:00","U.S. Cancer Death Rate Lowest In Recorded History! A lot of good news coming out of this Administration."
"1255",1255,1,4,-3,FALSE,"2020-01-09 13:46:26+00:00","Breaking News: The Fifth Circuit Court of Appeals just reversed a lower court decision & gave us the go ahead to build one of the largest sections of the desperately needed Southern Border Wall, Four Billion Dollars. Entire Wall is under construction or getting ready to start!"
"1256",1256,2,7,-5,FALSE,"2020-01-09 13:20:47+00:00","Hope that all House Republicans will vote against Crazy Nancy Pelosi’s War Powers Resolution. Also, remember her “speed & rush” in getting the Impeachment Hoax voted on & done. Well, she never sent the Articles to the Senate. Just another Democrat fraud. Presidential Harassment!"
"1257",1257,0,1,-1,FALSE,"2020-01-09 12:30:27+00:00","PRESIDENTIAL HARASSMENT!"
"1258",1258,1,0,1,FALSE,"2020-01-09 12:24:31+00:00","Thank you Elise!"
"1259",1259,1,8,-7,FALSE,"2020-01-09 12:21:44+00:00","Pelosi doesn’t want to hand over The Articles of Impeachment, which were fraudulently produced by corrupt politicians like Shifty Schiff in the first place, because after all of these years of investigations and persecution, they show no crimes and are a joke and a scam!"
"1260",1260,1,0,1,FALSE,"2020-01-09 11:58:51+00:00","Great!"
"1261",1261,0,0,0,FALSE,"2020-01-09 11:49:31+00:00","WINRED!"
"1262",1262,0,0,0,FALSE,"2020-01-09 11:47:40+00:00","See you later!"
"1263",1263,6,2,4,FALSE,"2020-01-08 02:45:24+00:00","All is well! Missiles launched from Iran at two military bases located in Iraq. Assessment of casualties & damages taking place now. So far, so good! We have the most powerful and well equipped military anywhere in the world, by far! I will be making a statement tomorrow morning."
"1264",1264,3,0,3,FALSE,"2020-01-07 19:05:20+00:00","Had a very good meeting with @kbsalsaud of Saudi Arabia. We discussed Trade, Military, Oil Prices, Security, and Stability in the Middle East!"
"1265",1265,2,1,1,FALSE,"2020-01-07 13:27:12+00:00","Great interview with @GOPLeader Kevin McCarthy on @foxandfriends. “There was no urgency with the Articles of Impeachment because there was no case.”"
"1266",1266,1,0,1,FALSE,"2020-01-07 11:44:32+00:00","We love Australia!"
"1267",1267,1,0,1,FALSE,"2020-01-07 00:40:15+00:00","Amazing analysis & reporting!"
"1268",1268,3,2,1,TRUE,"2020-01-06 23:50:10+00:00","....If however, the city or state in question is willing to acknowledge responsibility, and politely asks for help from the Federal Government, we will very seriously consider getting involved in order to make those poorly run Democrat Cities Great Again!"
"1269",1269,1,3,-2,TRUE,"2020-01-06 23:50:09+00:00","The homeless situation in Los Angeles, San Francisco, and many other Democrat Party run cities throughout the Nation is a state and local problem, not a federal problem...."
"1270",1270,0,0,0,FALSE,"2020-01-06 17:02:29+00:00",""
"1271",1271,0,0,0,FALSE,"2020-01-06 17:02:23+00:00",""
"1272",1272,0,1,-1,FALSE,"2020-01-06 14:48:27+00:00","IRAN WILL NEVER HAVE A NUCLEAR WEAPON!"
"1273",1273,2,6,-4,FALSE,"2020-01-06 14:39:43+00:00","Congress & the President should not be wasting their time and energy on a continuation of the totally partisan Impeachment Hoax when we have so many important matters pending. 196 to ZERO was the Republican House vote, & we got 3 Dems. This was not what the Founders had in mind!"
"1274",1274,3,4,-1,FALSE,"2020-01-06 14:32:49+00:00","The Impeachment Hoax, just a continuation of the Witch Hunt which started even before I won the Election, must end quickly. Read the Transcripts, see the Ukrainian President’s strong statement, NO PRESSURE - get this done. It is a con game by the Dems to help with the Election!"
"1275",1275,2,6,-4,FALSE,"2020-01-06 13:37:33+00:00","“The reason they are not sending the Articles of Impeachment to the Senate is that they are so weak and so pathetic.” @LindseyGrahamSC @MariaBartiromo The great Scam continues. To be spending time on this political Hoax at this moment in our history, when I am so busy, is sad!"
"1276",1276,1,5,-4,FALSE,"2020-01-05 20:25:32+00:00","These Media Posts will serve as notification to the United States Congress that should Iran strike any U.S. person or target, the United States will quickly & fully strike back, & perhaps in a disproportionate manner. Such legal notice is not required, but is given nevertheless!"
"1277",1277,3,2,1,FALSE,"2020-01-05 05:11:03+00:00","The United States just spent Two Trillion Dollars on Military Equipment. We are the biggest and by far the BEST in the World! If Iran attacks an American Base, or any American, we will be sending some of that brand new beautiful equipment their way...and without hesitation!"
"1278",1278,0,1,-1,FALSE,"2020-01-05 04:53:04+00:00","They attacked us, & we hit back. If they attack again, which I would strongly advise them not to do, we will hit them harder than they have ever been hit before!"
"1279",1279,2,5,-3,FALSE,"2020-01-04 22:52:05+00:00","....targeted 52 Iranian sites (representing the 52 American hostages taken by Iran many years ago), some at a very high level & important to Iran & the Iranian culture, and those targets, and Iran itself, WILL BE HIT VERY FAST AND VERY HARD. The USA wants no more threats!"
"1280",1280,0,4,-4,FALSE,"2020-01-04 22:52:05+00:00","....hundreds of Iranian protesters. He was already attacking our Embassy, and preparing for additional hits in other locations. Iran has been nothing but problems for many years. Let this serve as a WARNING that if Iran strikes any Americans, or American assets, we have....."
"1281",1281,0,5,-5,FALSE,"2020-01-04 22:52:03+00:00","Iran is talking very boldly about targeting certain USA assets as revenge for our ridding the world of their terrorist leader who had just killed an American, & badly wounded many others, not to mention all of the people he had killed over his lifetime, including recently...."
"1282",1282,5,5,0,FALSE,"2020-01-04 22:16:27+00:00","As hard as I work, & as successful as our Country has become with our Economy, our Military & everything else, it is ashame that the Democrats make us spend so much time & money on this ridiculous Impeachment Lite Hoax. I should be able to devote all of my time to the REAL USA!"
"1283",1283,3,0,3,FALSE,"2020-01-04 14:57:14+00:00","95% Approval Rating in the Republican Party. Thank you!"
"1284",1284,0,0,0,FALSE,"2020-01-04 04:29:47+00:00",""
"1285",1285,1,3,-2,FALSE,"2020-01-03 17:27:08+00:00","....followed, and then it was withdrawn. The Democrats argument for impeachment has not gotten stronger over the last few weeks. As Senator Josh Hawley just said, he’s going to enter a Motion to Dismiss the Impeachment Trial because it’s never actually been brought to trial.”"
"1286",1286,0,3,-3,FALSE,"2020-01-03 17:27:08+00:00","....different places that he thought were wasteful, and the career staff, as they always do, pushed back, and made a million excuses as to why they could not possibly stop spending U.S. taxpayer money. There was a back & forth over the legal arguments, & the W.H. decision was...."
"1287",1287,1,0,1,FALSE,"2020-01-03 17:27:07+00:00","Christopher Bedford, The Federalist Senior Editor. “There is NOTHING NEW in these Emails at all that’s been discovered. It’s exactly what we knew before, which is that the White House & political figures wanted to cut off aid, Trump wanted to question aid to a number of...."
"1288",1288,1,0,1,FALSE,"2020-01-03 15:25:27+00:00","This is a great book, a must read!"
"1289",1289,2,0,2,FALSE,"2020-01-03 15:09:33+00:00","....and more control over Iraq, and the people of Iraq are not happy with that. It will never end well!"
"1290",1290,3,2,1,FALSE,"2020-01-03 15:09:32+00:00","The United States has paid Iraq Billions of Dollars a year, for many years. That is on top of all else we have done for them. The people of Iraq don’t want to be dominated & controlled by Iran, but ultimately, that is their choice. Over the last 15 years, Iran has gained more...."
"1291",1291,2,4,-2,FALSE,"2020-01-03 13:54:43+00:00","....of PROTESTERS killed in Iran itself. While Iran will never be able to properly admit it, Soleimani was both hated and feared within the country. They are not nearly as saddened as the leaders will let the outside world believe. He should have been taken out many years ago!"
"1292",1292,0,4,-4,FALSE,"2020-01-03 13:54:43+00:00","General Qassem Soleimani has killed or badly wounded thousands of Americans over an extended period of time, and was plotting to kill many more...but got caught! He was directly and indirectly responsible for the death of millions of people, including the recent large number...."
"1293",1293,1,2,-1,FALSE,"2020-01-03 12:44:30+00:00","Iran never won a war, but never lost a negotiation!"
"1294",1294,0,0,0,FALSE,"2020-01-03 02:32:53+00:00",""
"1295",1295,0,5,-5,FALSE,"2020-01-02 13:58:02+00:00","....had happened to a Presidential candidate, or President, who was a Democrat, everybody involved would long ago be in jail for treason (and more), and it would be considered the CRIME OF THE CENTURY, far bigger and more sinister than Watergate!"
"1296",1296,1,6,-5,FALSE,"2020-01-02 13:58:01+00:00","A lot of very good people were taken down by a small group of Dirty (Filthy) Cops, politicians, government officials, and an investigation that was illegally started & that SPIED on my campaign. The Witch Hunt is sputtering badly, but still going on (Ukraine Hoax!). If this...."
"1297",1297,2,5,-3,FALSE,"2020-01-02 13:42:42+00:00","....it’s alienating independents. This President is being persecuted over three years with one investigation after another, and that really plays to his base.” @FoxNews @cvpayne Their partisan Witch Hunt is hurting our Country do badly, & only bringing more division than ever!"
"1298",1298,2,3,-1,FALSE,"2020-01-02 13:42:41+00:00","Sohrab Ahmari, New York Post “The Trump Campaign raised 10 million in the two days following the impeachment (Scam) vote. It seems the Democrats have shot themselves in the foot in one more way. They set up a process they know is not going to lead to the Presidents removal, &..."
"1299",1299,0,0,0,FALSE,"2020-01-02 02:46:45+00:00","They don’t know how to do that!"
"1300",1300,1,0,1,FALSE,"2020-01-02 01:53:15+00:00","Great job!"
"1301",1301,0,1,-1,FALSE,"2020-01-02 01:46:08+00:00","Can’t believe @ATT keeps the management after yet another @CNN ratings dive. Nobody watching, NO CREDIBILITY! Maybe they should make changes at AT&T?"
"1302",1302,2,1,1,FALSE,"2020-01-02 01:36:54+00:00","Too bad, Corey would have won! He (and I) loves New Hampshire."
"1303",1303,4,0,4,FALSE,"2020-01-02 01:32:31+00:00","Best equipment & finest military in the World. On site quickly!"
"1304",1304,0,0,0,FALSE,"2020-01-01 03:12:07+00:00",""
"1305",1305,1,0,1,FALSE,"2020-01-01 01:30:35+00:00","HAPPY NEW YEAR!"
"1306",1306,1,0,1,FALSE,"2020-01-01 01:22:28+00:00","Our fantastic First Lady!"
"1307",1307,3,1,2,FALSE,"2020-01-01 01:16:27+00:00","Thank you Steve. The greatest Witch Hunt in U.S. history!"
"1308",1308,1,0,1,FALSE,"2020-01-01 01:03:15+00:00","Thank you to the @dcexaminer Washington Examiner. The list is growing every day!"
"1309",1309,2,1,1,FALSE,"2020-01-01 00:55:01+00:00","One of my greatest honors was to have gotten CHOICE approved for our great Veterans. Others have tried for decades, and failed!"
